연도,읍면명,법정동명,세대수,총인원수,남자수,여자수,데이터기준일자
2008,화순읍,감도리1반,65,144,78,66,2025-07-31
2008,화순읍,감도리2반,44,103,53,50,2025-07-31
2008,화순읍,감도리3반,20,50,25,25,2025-07-31
2008,화순읍,강정리1반,7,14,8,6,2025-07-31
2008,화순읍,계소리1반,166,466,233,233,2025-07-31
2008,화순읍,계소리2반,22,37,19,18,2025-07-31
2008,화순읍,계소리3반,49,114,55,59,2025-07-31
2008,화순읍,계소리4반,266,674,348,326,2025-07-31
2008,화순읍,광덕리1반,323,820,401,419,2025-07-31
2008,화순읍,광덕리2반,208,562,298,264,2025-07-31
2008,화순읍,광덕리3반,71,192,103,89,2025-07-31
2008,화순읍,광덕리4반,542,1759,852,907,2025-07-31
2008,화순읍,광덕리5반,432,1379,656,723,2025-07-31
2008,화순읍,교리1반,368,902,463,439,2025-07-31
2008,화순읍,교리2반,524,1680,828,852,2025-07-31
2008,화순읍,교리3반,186,493,258,235,2025-07-31
2008,화순읍,내평리1반,118,281,149,132,2025-07-31
2008,화순읍,다지리1반,83,264,135,129,2025-07-31
2008,화순읍,다지리2반,71,163,76,87,2025-07-31
2008,화순읍,대리1반,262,597,292,305,2025-07-31
2008,화순읍,대리2반,66,164,74,90,2025-07-31
2008,화순읍,대리3반,52,149,79,70,2025-07-31
2008,화순읍,대리4반,95,231,116,115,2025-07-31
2008,화순읍,대리5반,411,1150,575,575,2025-07-31
2008,화순읍,대리6반,375,1267,617,650,2025-07-31
2008,화순읍,대리7반,393,883,399,484,2025-07-31
2008,화순읍,도웅리1반,79,161,75,86,2025-07-31
2008,화순읍,도웅리2반,27,48,22,26,2025-07-31
2008,화순읍,동구리1반,39,81,39,42,2025-07-31
2008,화순읍,만연리1반,135,355,183,172,2025-07-31
2008,화순읍,만연리2반,160,391,204,187,2025-07-31
2008,화순읍,만연리3반,848,2487,1182,1305,2025-07-31
2008,화순읍,만연리4반,515,1644,792,852,2025-07-31
2008,화순읍,만연리5반,1027,2641,1277,1364,2025-07-31
2008,화순읍,만연리6반,866,2416,1186,1230,2025-07-31
2008,화순읍,벽라리1반,105,237,120,117,2025-07-31
2008,화순읍,벽라리2반,142,326,160,166,2025-07-31
2008,화순읍,벽라리3반,398,1194,606,588,2025-07-31
2008,화순읍,삼천리1반,108,251,123,128,2025-07-31
2008,화순읍,삼천리2반,80,204,113,91,2025-07-31
2008,화순읍,삼천리3반,27,59,33,26,2025-07-31
2008,화순읍,삼천리4반,290,719,391,328,2025-07-31
2008,화순읍,서태리1반,84,199,113,86,2025-07-31
2008,화순읍,서태리2반,61,106,49,57,2025-07-31
2008,화순읍,세량리1반,48,104,56,48,2025-07-31
2008,화순읍,수만리1반,37,71,37,34,2025-07-31
2008,화순읍,수만리2반,28,58,35,23,2025-07-31
2008,화순읍,수만리3반,55,109,62,47,2025-07-31
2008,화순읍,신기리1반,443,1077,566,511,2025-07-31
2008,화순읍,신기리2반,1248,3616,1802,1814,2025-07-31
2008,화순읍,신기리3반,223,561,282,279,2025-07-31
2008,화순읍,앵남리1반,48,93,51,42,2025-07-31
2008,화순읍,앵남리2반,73,135,70,65,2025-07-31
2008,화순읍,연양리1반,50,114,61,53,2025-07-31
2008,화순읍,연양리2반,86,201,106,95,2025-07-31
2008,화순읍,유천리1반,46,112,61,51,2025-07-31
2008,화순읍,유천리2반,48,127,63,64,2025-07-31
2008,화순읍,유천리3반,41,92,43,49,2025-07-31
2008,화순읍,이십곡리,76,174,82,92,2025-07-31
2008,화순읍,이십곡리,38,92,46,46,2025-07-31
2008,화순읍,일심리1반,175,455,225,230,2025-07-31
2008,화순읍,일심리2반,50,107,58,49,2025-07-31
2008,화순읍,일심리3반,39,104,62,42,2025-07-31
2008,화순읍,일심리4반,442,1253,607,646,2025-07-31
2008,화순읍,일심리5반,561,1533,770,763,2025-07-31
2008,화순읍,일심리6반,668,2210,1068,1142,2025-07-31
2008,화순읍,주도리1반,39,65,34,31,2025-07-31
2008,화순읍,주도리2반,66,124,60,64,2025-07-31
2008,화순읍,주도리3반,48,102,50,52,2025-07-31
2008,화순읍,향청리1반,301,729,396,333,2025-07-31
2008,화순읍,훈리1반,213,501,247,254,2025-07-31
2008,한천면,모산1,105,219,110,109,2025-07-31
2008,한천면,모산2,27,43,24,19,2025-07-31
2008,한천면,금전리,86,160,72,88,2025-07-31
2008,한천면,한계1,103,231,119,112,2025-07-31
2008,한천면,한계2,58,130,64,66,2025-07-31
2008,한천면,정리1,22,36,21,15,2025-07-31
2008,한천면,정리2,27,75,37,38,2025-07-31
2008,한천면,가암1,35,68,36,32,2025-07-31
2008,한천면,가암2,40,68,31,37,2025-07-31
2008,한천면,오음1,42,107,52,55,2025-07-31
2008,한천면,오음2,28,62,34,28,2025-07-31
2008,한천면,오음3,36,56,32,24,2025-07-31
2008,한천면,반곡1,34,62,32,30,2025-07-31
2008,한천면,반곡2,39,78,39,39,2025-07-31
2008,한천면,평리,51,119,61,58,2025-07-31
2008,한천면,정우리,43,85,41,44,2025-07-31
2008,한천면,동가1,71,136,65,71,2025-07-31
2008,한천면,동가2,42,90,43,47,2025-07-31
2008,한천면,고시리,7,14,9,5,2025-07-31
2008,춘양면,석정리,248,542,279,263,2025-07-31
2008,춘양면,화림리1,33,68,29,39,2025-07-31
2008,춘양면,화림리2,54,106,59,47,2025-07-31
2008,춘양면,화림리3,36,67,29,38,2025-07-31
2008,춘양면,대신리1,39,76,42,34,2025-07-31
2008,춘양면,대신리2,23,40,18,22,2025-07-31
2008,춘양면,대신리3,30,52,29,23,2025-07-31
2008,춘양면,회송리1,37,65,29,36,2025-07-31
2008,춘양면,회송리2,29,60,36,24,2025-07-31
2008,춘양면,양곡리1,54,115,59,56,2025-07-31
2008,춘양면,용곡리1,50,86,39,47,2025-07-31
2008,춘양면,월평리1,43,93,39,54,2025-07-31
2008,춘양면,월평리2,29,50,25,25,2025-07-31
2008,춘양면,월평리3,16,29,15,14,2025-07-31
2008,춘양면,변천리1,54,111,52,59,2025-07-31
2008,춘양면,가동리1,12,18,10,8,2025-07-31
2008,춘양면,산간리1,58,122,55,67,2025-07-31
2008,춘양면,가봉리1,73,153,77,76,2025-07-31
2008,춘양면,용두리1,46,78,35,43,2025-07-31
2008,춘양면,우봉리1,82,247,101,146,2025-07-31
2008,춘양면,부곡리1,27,57,24,33,2025-07-31
2008,춘양면,부곡리2,34,73,36,37,2025-07-31
2008,춘양면,부곡리3,26,51,29,22,2025-07-31
2008,청풍면,풍암리1,80,159,79,80,2025-07-31
2008,청풍면,한지리1,40,78,42,36,2025-07-31
2008,청풍면,한지리2,27,56,22,34,2025-07-31
2008,청풍면,어리1,49,93,49,44,2025-07-31
2008,청풍면,세청리1,68,129,63,66,2025-07-31
2008,청풍면,세청리2,17,26,9,17,2025-07-31
2008,청풍면,대비리1,44,79,44,35,2025-07-31
2008,청풍면,백운리1,40,73,35,38,2025-07-31
2008,청풍면,청용리1,31,54,24,30,2025-07-31
2008,청풍면,이만리1,24,39,25,14,2025-07-31
2008,청풍면,신석리1,21,39,17,22,2025-07-31
2008,청풍면,신석리2,28,51,27,24,2025-07-31
2008,청풍면,신리1,56,106,57,49,2025-07-31
2008,청풍면,신리2,37,77,43,34,2025-07-31
2008,청풍면,차리1,32,60,22,38,2025-07-31
2008,청풍면,차리2,104,244,111,133,2025-07-31
2008,이양면,금능1,90,215,101,114,2025-07-31
2008,이양면,강성리1,54,86,37,49,2025-07-31
2008,이양면,강성리2,34,74,36,38,2025-07-31
2008,이양면,강성리3,32,51,24,27,2025-07-31
2008,이양면,용반리1,26,46,18,28,2025-07-31
2008,이양면,장치리1,20,44,19,25,2025-07-31
2008,이양면,묵곡리1,23,44,19,25,2025-07-31
2008,이양면,묵곡리2,33,82,38,44,2025-07-31
2008,이양면,옥리1,18,32,13,19,2025-07-31
2008,이양면,품평리1,50,95,45,50,2025-07-31
2008,이양면,품평리2,37,104,50,54,2025-07-31
2008,이양면,품평리3,40,90,45,45,2025-07-31
2008,이양면,오류리1,82,194,89,105,2025-07-31
2008,이양면,오류리2,41,96,50,46,2025-07-31
2008,이양면,오류리3,52,101,48,53,2025-07-31
2008,이양면,오류리4,26,51,26,25,2025-07-31
2008,이양면,이양리1,47,88,39,49,2025-07-31
2008,이양면,이양리2,61,159,73,86,2025-07-31
2008,이양면,율계리1,47,88,49,39,2025-07-31
2008,이양면,송정리1,26,46,21,25,2025-07-31
2008,이양면,송정리2,27,54,30,24,2025-07-31
2008,이양면,초방리1,21,44,19,25,2025-07-31
2008,이양면,초방리2,26,49,20,29,2025-07-31
2008,이양면,매정리1,26,55,25,30,2025-07-31
2008,이양면,매정리2,25,42,20,22,2025-07-31
2008,이양면,연화리1,29,49,27,22,2025-07-31
2008,이양면,구례리1,38,69,33,36,2025-07-31
2008,이양면,쌍봉리1,77,144,67,77,2025-07-31
2008,이양면,증리1,25,40,20,20,2025-07-31
2008,능주면,남정리1,132,312,155,157,2025-07-31
2008,능주면,남정리2,38,66,27,39,2025-07-31
2008,능주면,정남리1,85,215,107,108,2025-07-31
2008,능주면,석고리1,180,438,221,217,2025-07-31
2008,능주면,잠정리1,226,545,280,265,2025-07-31
2008,능주면,내리1,27,61,34,27,2025-07-31
2008,능주면,관영리1,311,760,375,385,2025-07-31
2008,능주면,천덕리1,71,137,70,67,2025-07-31
2008,능주면,천덕리2,42,100,45,55,2025-07-31
2008,능주면,만인리1,69,162,78,84,2025-07-31
2008,능주면,광사리1,47,110,63,47,2025-07-31
2008,능주면,백암리1,106,221,107,114,2025-07-31
2008,능주면,백암리2,52,115,63,52,2025-07-31
2008,능주면,만수리1,77,198,93,105,2025-07-31
2008,능주면,만수리2,50,142,75,67,2025-07-31
2008,능주면,원지리1,105,237,113,124,2025-07-31
2008,도곡면,대곡리1반,39,97,50,47,2025-07-31
2008,도곡면,대곡리2반,61,122,63,59,2025-07-31
2008,도곡면,대곡리3반,57,121,59,62,2025-07-31
2008,도곡면,효산리1반,121,285,141,144,2025-07-31
2008,도곡면,효산리2반,64,146,67,79,2025-07-31
2008,도곡면,월곡리1반,36,63,31,32,2025-07-31
2008,도곡면,월곡리2반,44,87,41,46,2025-07-31
2008,도곡면,월곡리3반,32,70,38,32,2025-07-31
2008,도곡면,쌍옥리1반,71,150,73,77,2025-07-31
2008,도곡면,쌍옥리2반,59,110,62,48,2025-07-31
2008,도곡면,평리1반,74,174,86,88,2025-07-31
2008,도곡면,덕곡리1반,38,61,27,34,2025-07-31
2008,도곡면,덕곡리2반,30,81,44,37,2025-07-31
2008,도곡면,신성리1반,48,113,51,62,2025-07-31
2008,도곡면,신성리2반,53,109,54,55,2025-07-31
2008,도곡면,천암리1반,175,410,208,202,2025-07-31
2008,도곡면,원화리1반,69,136,75,61,2025-07-31
2008,도곡면,원화리2반,51,93,50,43,2025-07-31
2008,도곡면,신덕리1반,49,105,49,56,2025-07-31
2008,도곡면,신덕리2반,44,75,34,41,2025-07-31
2008,도곡면,신덕리3반,40,83,40,43,2025-07-31
2008,도곡면,미곡리1반,29,65,33,32,2025-07-31
2008,도곡면,미곡리2반,40,82,38,44,2025-07-31
2008,도곡면,족청리1반,77,189,98,91,2025-07-31
2008,도곡면,족청리2반,24,44,20,24,2025-07-31
2008,도암면,운월리1,36,66,30,36,2025-07-31
2008,도암면,운월리2,33,55,32,23,2025-07-31
2008,도암면,도장리1,69,159,78,81,2025-07-31
2008,도암면,벽지리1,35,67,28,39,2025-07-31
2008,도암면,벽지리1,22,61,35,26,2025-07-31
2008,도암면,정천리1,77,142,76,66,2025-07-31
2008,도암면,원천리1,50,96,52,44,2025-07-31
2008,도암면,원천리2,27,59,32,27,2025-07-31
2008,도암면,원천리3,43,89,44,45,2025-07-31
2008,도암면,천태리1,31,66,36,30,2025-07-31
2008,도암면,천태리2,31,65,29,36,2025-07-31
2008,도암면,지월리1,21,53,27,26,2025-07-31
2008,도암면,지월리2,50,101,47,54,2025-07-31
2008,도암면,등광리1,51,91,48,43,2025-07-31
2008,도암면,대초리1,31,57,24,33,2025-07-31
2008,도암면,용강리1,56,94,53,41,2025-07-31
2008,도암면,용강리2,29,55,28,27,2025-07-31
2008,도암면,용강리3,42,99,54,45,2025-07-31
2008,도암면,호암리1,18,33,19,14,2025-07-31
2008,도암면,호암리2,23,38,18,20,2025-07-31
2008,도암면,우치리1,20,33,15,18,2025-07-31
2008,도암면,봉하리1,25,38,22,16,2025-07-31
2008,도암면,왕정리1,5,9,4,5,2025-07-31
2008,도암면,행산리1,8,20,10,10,2025-07-31
2008,이서면,"서리,월산리1",13,21,14,7,2025-07-31
2008,이서면,창랑리1,38,56,26,30,2025-07-31
2008,이서면,야사리1,61,128,67,61,2025-07-31
2008,이서면,야사리2,47,98,52,46,2025-07-31
2008,이서면,야사리3,24,58,25,33,2025-07-31
2008,이서면,야사리4,29,50,25,25,2025-07-31
2008,이서면,보월리1,66,147,76,71,2025-07-31
2008,이서면,보월리2,19,33,18,15,2025-07-31
2008,이서면,인계리1,41,69,31,38,2025-07-31
2008,이서면,인계리2,29,60,28,32,2025-07-31
2008,이서면,영평리1,76,151,76,75,2025-07-31
2008,이서면,안심리1,56,115,56,59,2025-07-31
2008,이서면,안심리2,27,48,29,19,2025-07-31
2008,이서면,갈두리1,7,13,3,1,2025-07-31
2008,백아면,임곡리1,64,124,61,63,2025-07-31
2008,백아면,옥리1구1,59,107,51,56,2025-07-31
2008,백아면,옥리2구2,31,51,23,28,2025-07-31
2008,백아면,서유리1구1,64,131,66,65,2025-07-31
2008,백아면,서유리2구2,25,54,26,28,2025-07-31
2008,백아면,맹리1,39,71,39,32,2025-07-31
2008,백아면,남치리1,50,108,50,58,2025-07-31
2008,백아면,원리1,115,243,117,126,2025-07-31
2008,백아면,송단리1구1,37,75,36,39,2025-07-31
2008,백아면,송단리2구2,42,69,35,34,2025-07-31
2008,백아면,방리1,33,68,36,32,2025-07-31
2008,백아면,노기리1,34,88,45,43,2025-07-31
2008,백아면,이천리1구1,54,114,55,59,2025-07-31
2008,백아면,이천리2구2,49,109,58,51,2025-07-31
2008,백아면,길성리1,66,110,48,62,2025-07-31
2008,백아면,와천리1,19,43,19,24,2025-07-31
2008,백아면,다곡리1,69,123,60,63,2025-07-31
2008,백아면,수리1,80,162,73,89,2025-07-31
2008,백아면,노치리1,20,58,31,27,2025-07-31
2008,백아면,용곡리1구1,38,63,30,33,2025-07-31
2008,백아면,용곡리2구2,21,31,15,16,2025-07-31
2008,동복면,독상리1,110,231,121,110,2025-07-31
2008,동복면,칠정리1,58,114,55,59,2025-07-31
2008,동복면,칠정리2,37,76,30,46,2025-07-31
2008,동복면,천변리1,103,245,125,120,2025-07-31
2008,동복면,유천리1,84,154,85,69,2025-07-31
2008,동복면,신율리1,45,93,47,46,2025-07-31
2008,동복면,신율리2,23,55,27,28,2025-07-31
2008,동복면,신율리3,30,62,29,33,2025-07-31
2008,동복면,가수리1,42,97,47,50,2025-07-31
2008,동복면,가수리2,18,40,13,27,2025-07-31
2008,동복면,가수리3,18,30,14,16,2025-07-31
2008,동복면,안성리1,57,124,66,58,2025-07-31
2008,동복면,연월리1,44,84,34,50,2025-07-31
2008,동복면,연월리2,30,49,22,27,2025-07-31
2008,동복면,연월리3,32,66,34,32,2025-07-31
2008,동복면,읍애리1,39,77,42,35,2025-07-31
2008,동복면,연둔리1,38,62,21,41,2025-07-31
2008,동복면,연둔리2,24,39,17,22,2025-07-31
2008,동복면,구암리1,30,65,34,31,2025-07-31
2008,동복면,구암리2,31,55,31,24,2025-07-31
2008,동복면,한천리1,111,198,92,106,2025-07-31
2008,사평면,사평리1,54,116,59,57,2025-07-31
2008,사평면,사평리2,82,172,87,85,2025-07-31
2008,사평면,사평리3,57,161,83,78,2025-07-31
2008,사평면,사평리4,73,189,90,99,2025-07-31
2008,사평면,사평리5,47,103,47,56,2025-07-31
2008,사평면,대곡리1,42,88,44,44,2025-07-31
2008,사평면,대곡리2,20,36,15,21,2025-07-31
2008,사평면,검산리1,47,93,55,38,2025-07-31
2008,사평면,검산리2,23,48,26,22,2025-07-31
2008,사평면,운산리1,34,67,35,32,2025-07-31
2008,사평면,원리1,50,98,43,55,2025-07-31
2008,사평면,원리2,39,74,38,36,2025-07-31
2008,사평면,벽송리1,110,239,121,118,2025-07-31
2008,사평면,벽송리2,28,50,20,30,2025-07-31
2008,사평면,장전리1,49,110,50,60,2025-07-31
2008,사평면,장전리2,39,88,44,44,2025-07-31
2008,사평면,절산리1,79,149,69,80,2025-07-31
2008,사평면,절산리2,41,67,33,34,2025-07-31
2008,사평면,사수리1,30,62,33,29,2025-07-31
2008,사평면,사수리2,29,54,27,27,2025-07-31
2008,사평면,주산리1,30,64,30,34,2025-07-31
2008,사평면,복교리1,12,25,15,10,2025-07-31
2008,사평면,남계리1,55,92,42,50,2025-07-31
2008,사평면,유마리1,24,43,18,25,2025-07-31
2008,사평면,다산리1,50,111,52,59,2025-07-31
2008,사평면,용리1,25,44,21,23,2025-07-31
2008,사평면,용리2,49,93,47,46,2025-07-31
2008,사평면,내리1,31,53,22,31,2025-07-31
2008,사평면,내리2,22,47,26,21,2025-07-31
2008,사평면,내리3,37,88,52,36,2025-07-31
2008,동면,백용리1,42,102,50,52,2025-07-31
2008,동면,백용리2,80,187,91,96,2025-07-31
2008,동면,언도리1,64,123,61,62,2025-07-31
2008,동면,언도리2,46,133,63,70,2025-07-31
2008,동면,서성리1,28,48,27,21,2025-07-31
2008,동면,서성리2,31,66,35,31,2025-07-31
2008,동면,국동리1,35,67,35,32,2025-07-31
2008,동면,청궁리2,55,97,47,50,2025-07-31
2008,동면,마산리1,45,104,55,49,2025-07-31
2008,동면,무포리1,37,72,35,37,2025-07-31
2008,동면,무포리2,22,53,25,28,2025-07-31
2008,동면,경치리1,52,99,46,53,2025-07-31
2008,동면,경치리2,14,40,15,25,2025-07-31
2008,동면,복암리1,66,102,49,53,2025-07-31
2008,동면,복암리2,164,309,172,137,2025-07-31
2008,동면,복암리3,65,110,54,56,2025-07-31
2008,동면,오동리1,148,353,184,169,2025-07-31
2008,동면,오동리2,36,68,40,28,2025-07-31
2008,동면,오동리3,60,126,59,67,2025-07-31
2008,동면,천덕리1,47,105,60,45,2025-07-31
2008,동면,천덕리2,41,102,55,47,2025-07-31
2008,동면,천덕리3,80,178,89,89,2025-07-31
2008,동면,장동리1,121,267,113,154,2025-07-31
2008,동면,장동리2,98,210,95,115,2025-07-31
2008,동면,운농리1,77,190,98,92,2025-07-31
2008,동면,운농리2,77,163,95,68,2025-07-31
2008,동면,운농리3,74,162,86,76,2025-07-31
2008,동면,옥호리1,26,49,24,25,2025-07-31
2008,동면,옥호리2,35,64,30,34,2025-07-31
2008,동면,옥호리3,15,30,14,16,2025-07-31
2008,동면,대포리1,69,139,73,66,2025-07-31
2008,동면,대포리2,40,85,40,45,2025-07-31
2008,동면,대포리3,64,130,69,61,2025-07-31
2009,화순읍,감도리1반,64,139,76,63,2025-07-31
2009,화순읍,감도리2반,43,94,49,45,2025-07-31
2009,화순읍,감도리3반,20,47,24,23,2025-07-31
2009,화순읍,강정리1반,8,15,9,6,2025-07-31
2009,화순읍,계소리1반,164,455,220,235,2025-07-31
2009,화순읍,계소리2반,23,38,18,20,2025-07-31
2009,화순읍,계소리3반,45,103,55,48,2025-07-31
2009,화순읍,계소리4반,266,662,340,322,2025-07-31
2009,화순읍,광덕리1반,323,788,394,394,2025-07-31
2009,화순읍,광덕리2반,208,533,281,252,2025-07-31
2009,화순읍,광덕리3반,70,182,100,82,2025-07-31
2009,화순읍,광덕리4반,549,1735,846,889,2025-07-31
2009,화순읍,광덕리5반,453,1415,671,744,2025-07-31
2009,화순읍,교리1반,345,813,424,389,2025-07-31
2009,화순읍,교리2반,540,1738,848,890,2025-07-31
2009,화순읍,교리3반,187,480,256,224,2025-07-31
2009,화순읍,내평리1반,115,271,142,129,2025-07-31
2009,화순읍,다지리1반,81,235,128,107,2025-07-31
2009,화순읍,다지리2반,72,169,79,90,2025-07-31
2009,화순읍,대리1반,262,635,310,325,2025-07-31
2009,화순읍,대리2반,62,160,78,82,2025-07-31
2009,화순읍,대리3반,51,142,75,67,2025-07-31
2009,화순읍,대리4반,147,382,179,203,2025-07-31
2009,화순읍,대리5반,422,1170,577,593,2025-07-31
2009,화순읍,대리6반,382,1290,618,672,2025-07-31
2009,화순읍,대리7반,407,907,417,490,2025-07-31
2009,화순읍,도웅리1반,81,155,70,85,2025-07-31
2009,화순읍,도웅리2반,26,43,19,24,2025-07-31
2009,화순읍,동구리1반,38,77,39,38,2025-07-31
2009,화순읍,만연리1반,128,326,169,157,2025-07-31
2009,화순읍,만연리2반,166,391,199,192,2025-07-31
2009,화순읍,만연리3반,894,2533,1205,1328,2025-07-31
2009,화순읍,만연리4반,512,1656,788,868,2025-07-31
2009,화순읍,만연리5반,1036,2711,1294,1417,2025-07-31
2009,화순읍,만연리6반,896,2490,1215,1275,2025-07-31
2009,화순읍,벽라리1반,100,221,108,113,2025-07-31
2009,화순읍,벽라리2반,144,325,163,162,2025-07-31
2009,화순읍,벽라리3반,388,1125,579,546,2025-07-31
2009,화순읍,삼천리1반,109,247,124,123,2025-07-31
2009,화순읍,삼천리2반,83,214,118,96,2025-07-31
2009,화순읍,삼천리3반,26,62,33,29,2025-07-31
2009,화순읍,삼천리4반,293,685,371,314,2025-07-31
2009,화순읍,서태리1반,85,191,108,83,2025-07-31
2009,화순읍,서태리2반,52,92,41,51,2025-07-31
2009,화순읍,세량리1반,53,106,53,53,2025-07-31
2009,화순읍,수만리1반,38,75,41,34,2025-07-31
2009,화순읍,수만리2반,27,58,33,25,2025-07-31
2009,화순읍,수만리3반,52,101,54,47,2025-07-31
2009,화순읍,신기리1반,411,980,510,470,2025-07-31
2009,화순읍,신기리2반,1276,3702,1873,1829,2025-07-31
2009,화순읍,신기리3반,242,610,300,310,2025-07-31
2009,화순읍,앵남리1반,47,97,52,45,2025-07-31
2009,화순읍,앵남리2반,67,128,62,66,2025-07-31
2009,화순읍,연양리1반,51,110,60,50,2025-07-31
2009,화순읍,연양리2반,89,196,111,85,2025-07-31
2009,화순읍,유천리1반,51,116,64,52,2025-07-31
2009,화순읍,유천리2반,44,103,51,52,2025-07-31
2009,화순읍,유천리3반,39,94,45,49,2025-07-31
2009,화순읍,이십곡리,78,168,86,82,2025-07-31
2009,화순읍,이십곡리,40,92,46,46,2025-07-31
2009,화순읍,일심리1반,190,504,245,259,2025-07-31
2009,화순읍,일심리2반,50,109,56,53,2025-07-31
2009,화순읍,일심리3반,43,119,63,56,2025-07-31
2009,화순읍,일심리4반,424,1176,592,584,2025-07-31
2009,화순읍,일심리5반,529,1403,687,716,2025-07-31
2009,화순읍,일심리6반,665,2177,1059,1118,2025-07-31
2009,화순읍,주도리1반,37,66,35,31,2025-07-31
2009,화순읍,주도리2반,66,116,55,61,2025-07-31
2009,화순읍,주도리3반,49,100,50,50,2025-07-31
2009,화순읍,향청리1반,306,724,385,339,2025-07-31
2009,화순읍,훈리1반,200,469,238,231,2025-07-31
2009,한천면,모산1,94,206,103,103,2025-07-31
2009,한천면,모산2,28,40,18,22,2025-07-31
2009,한천면,금전리,82,147,65,82,2025-07-31
2009,한천면,한계1,107,220,113,107,2025-07-31
2009,한천면,한계2,56,124,60,64,2025-07-31
2009,한천면,정리1,18,29,17,12,2025-07-31
2009,한천면,정리2,30,86,40,46,2025-07-31
2009,한천면,가암1,33,63,31,32,2025-07-31
2009,한천면,가암2,38,66,27,39,2025-07-31
2009,한천면,오음1,43,95,45,50,2025-07-31
2009,한천면,오음2,23,50,26,24,2025-07-31
2009,한천면,오음3,36,59,35,24,2025-07-31
2009,한천면,반곡1,37,71,36,35,2025-07-31
2009,한천면,반곡2,42,77,39,38,2025-07-31
2009,한천면,평리,51,113,57,56,2025-07-31
2009,한천면,정우리,45,84,41,43,2025-07-31
2009,한천면,동가1,69,135,64,71,2025-07-31
2009,한천면,동가2,39,86,42,44,2025-07-31
2009,한천면,고시리,7,12,9,3,2025-07-31
2009,춘양면,석정리,245,520,269,251,2025-07-31
2009,춘양면,화림리1,32,68,30,38,2025-07-31
2009,춘양면,화림리2,60,110,61,49,2025-07-31
2009,춘양면,화림리3,35,66,29,37,2025-07-31
2009,춘양면,대신리1,37,77,40,37,2025-07-31
2009,춘양면,대신리2,26,43,21,22,2025-07-31
2009,춘양면,대신리3,27,46,25,21,2025-07-31
2009,춘양면,회송리1,36,63,28,35,2025-07-31
2009,춘양면,회송리2,31,54,30,24,2025-07-31
2009,춘양면,양곡리1,54,113,60,53,2025-07-31
2009,춘양면,용곡리1,52,91,46,45,2025-07-31
2009,춘양면,월평리1,43,92,40,52,2025-07-31
2009,춘양면,월평리2,29,46,24,22,2025-07-31
2009,춘양면,월평리3,16,32,15,17,2025-07-31
2009,춘양면,변천리1,51,97,43,54,2025-07-31
2009,춘양면,가동리1,12,18,10,8,2025-07-31
2009,춘양면,산간리1,60,118,52,66,2025-07-31
2009,춘양면,가봉리1,75,148,73,75,2025-07-31
2009,춘양면,용두리1,44,75,33,42,2025-07-31
2009,춘양면,우봉리1,77,229,92,137,2025-07-31
2009,춘양면,부곡리1,27,50,22,28,2025-07-31
2009,춘양면,부곡리2,35,71,34,37,2025-07-31
2009,춘양면,부곡리3,27,55,32,23,2025-07-31
2009,청풍면,풍암리1,79,153,73,80,2025-07-31
2009,청풍면,한지리1,39,76,42,34,2025-07-31
2009,청풍면,한지리2,29,58,24,34,2025-07-31
2009,청풍면,어리1,47,83,39,44,2025-07-31
2009,청풍면,세청리1,67,132,69,63,2025-07-31
2009,청풍면,세청리2,17,25,8,17,2025-07-31
2009,청풍면,대비리1,43,81,45,36,2025-07-31
2009,청풍면,백운리1,39,75,36,39,2025-07-31
2009,청풍면,청용리1,32,50,23,27,2025-07-31
2009,청풍면,이만리1,19,31,20,11,2025-07-31
2009,청풍면,신석리1,22,41,18,23,2025-07-31
2009,청풍면,신석리2,27,46,25,21,2025-07-31
2009,청풍면,신리1,57,102,56,46,2025-07-31
2009,청풍면,신리2,39,79,46,33,2025-07-31
2009,청풍면,차리1,32,61,23,38,2025-07-31
2009,청풍면,차리2,102,223,101,122,2025-07-31
2009,이양면,금능1,91,218,98,120,2025-07-31
2009,이양면,강성리1,52,79,34,45,2025-07-31
2009,이양면,강성리2,34,75,40,35,2025-07-31
2009,이양면,강성리3,32,54,24,30,2025-07-31
2009,이양면,용반리1,28,51,19,32,2025-07-31
2009,이양면,장치리1,20,44,19,25,2025-07-31
2009,이양면,묵곡리1,24,44,21,23,2025-07-31
2009,이양면,묵곡리2,33,60,36,44,2025-07-31
2009,이양면,옥리1,18,40,20,20,2025-07-31
2009,이양면,품평리1,49,91,43,48,2025-07-31
2009,이양면,품평리2,38,100,50,50,2025-07-31
2009,이양면,품평리3,43,86,45,41,2025-07-31
2009,이양면,오류리1,83,191,82,109,2025-07-31
2009,이양면,오류리2,44,96,52,44,2025-07-31
2009,이양면,오류리3,50,97,45,52,2025-07-31
2009,이양면,오류리4,26,56,29,27,2025-07-31
2009,이양면,이양리1,51,91,36,55,2025-07-31
2009,이양면,이양리2,58,139,67,72,2025-07-31
2009,이양면,율계리1,45,86,47,39,2025-07-31
2009,이양면,송정리1,23,41,18,23,2025-07-31
2009,이양면,송정리2,28,52,31,21,2025-07-31
2009,이양면,초방리1,23,47,21,26,2025-07-31
2009,이양면,초방리2,26,44,18,26,2025-07-31
2009,이양면,매정리1,27,55,26,29,2025-07-31
2009,이양면,매정리2,32,53,26,27,2025-07-31
2009,이양면,연화리1,26,50,31,19,2025-07-31
2009,이양면,구례리1,36,64,31,33,2025-07-31
2009,이양면,쌍봉리1,75,140,63,77,2025-07-31
2009,이양면,증리1,25,41,21,20,2025-07-31
2009,능주면,남정리1,138,306,154,152,2025-07-31
2009,능주면,남정리2,34,61,25,36,2025-07-31
2009,능주면,정남리1,89,215,104,111,2025-07-31
2009,능주면,석고리1,190,449,231,218,2025-07-31
2009,능주면,잠정리1,222,523,262,261,2025-07-31
2009,능주면,내리1,30,69,39,30,2025-07-31
2009,능주면,관영리1,301,721,350,371,2025-07-31
2009,능주면,천덕리1,67,132,69,63,2025-07-31
2009,능주면,천덕리2,44,103,46,57,2025-07-31
2009,능주면,만인리1,70,158,76,82,2025-07-31
2009,능주면,광사리1,44,102,60,42,2025-07-31
2009,능주면,백암리1,98,207,102,105,2025-07-31
2009,능주면,백암리2,53,113,60,53,2025-07-31
2009,능주면,만수리1,75,183,88,95,2025-07-31
2009,능주면,만수리2,56,138,70,68,2025-07-31
2009,능주면,원지리1,103,213,103,110,2025-07-31
2009,도곡면,대곡리1반,37,85,43,42,2025-07-31
2009,도곡면,대곡리2반,55,108,57,51,2025-07-31
2009,도곡면,대곡리3반,55,111,53,58,2025-07-31
2009,도곡면,효산리1반,129,284,144,140,2025-07-31
2009,도곡면,효산리2반,73,159,72,87,2025-07-31
2009,도곡면,월곡리1반,38,68,31,37,2025-07-31
2009,도곡면,월곡리2반,46,87,38,49,2025-07-31
2009,도곡면,월곡리3반,29,61,35,26,2025-07-31
2009,도곡면,쌍옥리1반,76,166,82,84,2025-07-31
2009,도곡면,쌍옥리2반,59,115,64,51,2025-07-31
2009,도곡면,평리1반,69,157,77,80,2025-07-31
2009,도곡면,덕곡리1반,41,65,25,40,2025-07-31
2009,도곡면,덕곡리2반,32,80,42,38,2025-07-31
2009,도곡면,신성리1반,51,105,48,57,2025-07-31
2009,도곡면,신성리2반,50,107,50,57,2025-07-31
2009,도곡면,천암리1반,194,460,238,222,2025-07-31
2009,도곡면,원화리1반,77,154,83,71,2025-07-31
2009,도곡면,원화리2반,45,85,43,42,2025-07-31
2009,도곡면,신덕리1반,48,93,42,51,2025-07-31
2009,도곡면,신덕리2반,42,72,32,40,2025-07-31
2009,도곡면,신덕리3반,40,86,44,42,2025-07-31
2009,도곡면,미곡리1반,31,64,32,32,2025-07-31
2009,도곡면,미곡리2반,45,88,40,48,2025-07-31
2009,도곡면,족청리1반,79,183,97,86,2025-07-31
2009,도곡면,족청리2반,24,40,20,20,2025-07-31
2009,도암면,운월리1,33,62,30,32,2025-07-31
2009,도암면,운월리2,33,54,32,22,2025-07-31
2009,도암면,도장리1,69,157,75,82,2025-07-31
2009,도암면,벽지리1,34,58,23,35,2025-07-31
2009,도암면,벽지리1,22,53,30,23,2025-07-31
2009,도암면,정천리1,78,145,78,67,2025-07-31
2009,도암면,원천리1,46,90,48,42,2025-07-31
2009,도암면,원천리2,25,56,30,26,2025-07-31
2009,도암면,원천리3,43,87,42,45,2025-07-31
2009,도암면,천태리1,31,66,34,32,2025-07-31
2009,도암면,천태리2,31,67,31,36,2025-07-31
2009,도암면,지월리1,20,54,29,25,2025-07-31
2009,도암면,지월리2,50,97,47,50,2025-07-31
2009,도암면,등광리1,53,88,44,44,2025-07-31
2009,도암면,대초리1,32,59,24,35,2025-07-31
2009,도암면,용강리1,56,91,49,42,2025-07-31
2009,도암면,용강리2,30,56,30,26,2025-07-31
2009,도암면,용강리3,43,97,55,42,2025-07-31
2009,도암면,호암리1,21,38,22,16,2025-07-31
2009,도암면,호암리2,25,39,18,21,2025-07-31
2009,도암면,우치리1,20,32,13,19,2025-07-31
2009,도암면,봉하리1,27,48,25,23,2025-07-31
2009,도암면,왕정리1,6,10,5,5,2025-07-31
2009,도암면,행산리1,9,23,10,13,2025-07-31
2009,이서면,"서리,월산리1",15,29,17,12,2025-07-31
2009,이서면,창랑리1,38,54,25,29,2025-07-31
2009,이서면,야사리1,60,121,66,55,2025-07-31
2009,이서면,야사리2,44,97,50,47,2025-07-31
2009,이서면,야사리3,26,61,29,32,2025-07-31
2009,이서면,야사리4,34,52,24,28,2025-07-31
2009,이서면,보월리1,67,147,74,73,2025-07-31
2009,이서면,보월리2,22,36,20,16,2025-07-31
2009,이서면,인계리1,39,68,29,39,2025-07-31
2009,이서면,인계리2,27,59,28,31,2025-07-31
2009,이서면,영평리1,84,152,78,74,2025-07-31
2009,이서면,안심리1,54,110,53,57,2025-07-31
2009,이서면,안심리2,25,49,31,18,2025-07-31
2009,이서면,갈두리1,7,13,9,4,2025-07-31
2009,백아면,임곡리1,61,121,61,60,2025-07-31
2009,백아면,옥리1구1,60,110,53,57,2025-07-31
2009,백아면,옥리2구2,30,54,26,28,2025-07-31
2009,백아면,서유리1구1,65,123,60,63,2025-07-31
2009,백아면,서유리2구2,26,54,27,27,2025-07-31
2009,백아면,맹리1,38,67,36,31,2025-07-31
2009,백아면,남치리1,50,105,49,56,2025-07-31
2009,백아면,원리1,120,246,117,129,2025-07-31
2009,백아면,송단리1구1,39,75,37,38,2025-07-31
2009,백아면,송단리2구2,44,77,39,38,2025-07-31
2009,백아면,방리1,33,73,37,36,2025-07-31
2009,백아면,노기리1,36,85,44,41,2025-07-31
2009,백아면,이천리1구1,54,106,51,55,2025-07-31
2009,백아면,이천리2구2,56,112,57,55,2025-07-31
2009,백아면,길성리1,64,100,46,54,2025-07-31
2009,백아면,와천리1,19,38,17,21,2025-07-31
2009,백아면,다곡리1,72,127,57,70,2025-07-31
2009,백아면,수리1,82,165,76,89,2025-07-31
2009,백아면,노치리1,21,59,31,28,2025-07-31
2009,백아면,용곡리1구1,37,61,29,32,2025-07-31
2009,백아면,용곡리2구2,20,29,13,16,2025-07-31
2009,동복면,독상리1,114,235,118,117,2025-07-31
2009,동복면,칠정리1,64,131,63,68,2025-07-31
2009,동복면,칠정리2,38,81,34,47,2025-07-31
2009,동복면,천변리1,104,252,131,121,2025-07-31
2009,동복면,유천리1,83,144,76,68,2025-07-31
2009,동복면,신율리1,45,93,49,44,2025-07-31
2009,동복면,신율리2,21,50,23,27,2025-07-31
2009,동복면,신율리3,27,56,25,31,2025-07-31
2009,동복면,가수리1,42,94,45,49,2025-07-31
2009,동복면,가수리2,20,41,14,27,2025-07-31
2009,동복면,가수리3,21,39,20,19,2025-07-31
2009,동복면,안성리1,62,126,69,57,2025-07-31
2009,동복면,연월리1,47,85,33,52,2025-07-31
2009,동복면,연월리2,29,46,21,25,2025-07-31
2009,동복면,연월리3,36,72,36,36,2025-07-31
2009,동복면,읍애리1,38,69,37,32,2025-07-31
2009,동복면,연둔리1,38,62,24,38,2025-07-31
2009,동복면,연둔리2,23,37,16,21,2025-07-31
2009,동복면,구암리1,31,78,35,43,2025-07-31
2009,동복면,구암리2,34,60,31,29,2025-07-31
2009,동복면,한천리1,108,194,88,106,2025-07-31
2009,사평면,사평리1,53,113,62,51,2025-07-31
2009,사평면,사평리2,78,167,81,86,2025-07-31
2009,사평면,사평리3,61,149,79,70,2025-07-31
2009,사평면,사평리4,72,177,86,91,2025-07-31
2009,사평면,사평리5,45,97,45,52,2025-07-31
2009,사평면,대곡리1,44,92,42,50,2025-07-31
2009,사평면,대곡리2,19,39,19,20,2025-07-31
2009,사평면,검산리1,48,90,51,39,2025-07-31
2009,사평면,검산리2,22,43,21,22,2025-07-31
2009,사평면,운산리1,38,64,35,29,2025-07-31
2009,사평면,원리1,49,99,42,57,2025-07-31
2009,사평면,원리2,35,67,34,33,2025-07-31
2009,사평면,벽송리1,105,227,114,113,2025-07-31
2009,사평면,벽송리2,27,48,21,27,2025-07-31
2009,사평면,장전리1,48,108,49,59,2025-07-31
2009,사평면,장전리2,33,73,37,36,2025-07-31
2009,사평면,절산리1,75,149,67,82,2025-07-31
2009,사평면,절산리2,44,70,34,36,2025-07-31
2009,사평면,사수리1,27,61,34,27,2025-07-31
2009,사평면,사수리2,27,480,26,22,2025-07-31
2009,사평면,주산리1,28,63,34,29,2025-07-31
2009,사평면,복교리1,12,25,15,10,2025-07-31
2009,사평면,남계리1,55,93,43,50,2025-07-31
2009,사평면,남계리2,1,1,0,1,2025-07-31
2009,사평면,유마리1,26,45,20,25,2025-07-31
2009,사평면,다산리1,52,110,54,56,2025-07-31
2009,사평면,용리1,25,42,20,22,2025-07-31
2009,사평면,용리2,43,88,45,43,2025-07-31
2009,사평면,내리1,35,59,25,34,2025-07-31
2009,사평면,내리2,23,41,21,20,2025-07-31
2009,사평면,내리3,38,86,52,34,2025-07-31
2009,동면,백용리1,43,105,53,52,2025-07-31
2009,동면,백용리2,77,182,91,91,2025-07-31
2009,동면,언도리1,67,127,61,66,2025-07-31
2009,동면,언도리2,45,121,58,63,2025-07-31
2009,동면,서성리1,31,55,26,29,2025-07-31
2009,동면,서성리2,29,63,33,30,2025-07-31
2009,동면,국동리1,34,61,32,29,2025-07-31
2009,동면,청궁리2,58,101,52,49,2025-07-31
2009,동면,마산리1,45,104,53,51,2025-07-31
2009,동면,무포리1,36,71,38,33,2025-07-31
2009,동면,무포리2,22,44,22,22,2025-07-31
2009,동면,경치리1,50,93,44,49,2025-07-31
2009,동면,경치리2,14,43,16,27,2025-07-31
2009,동면,복암리1,68,107,53,54,2025-07-31
2009,동면,복암리2,171,304,169,135,2025-07-31
2009,동면,복암리3,62,102,47,55,2025-07-31
2009,동면,오동리1,141,337,167,170,2025-07-31
2009,동면,오동리2,40,76,44,32,2025-07-31
2009,동면,오동리3,63,125,62,63,2025-07-31
2009,동면,천덕리1,48,100,54,46,2025-07-31
2009,동면,천덕리2,45,107,64,43,2025-07-31
2009,동면,천덕리3,74,160,83,77,2025-07-31
2009,동면,장동리1,118,263,120,143,2025-07-31
2009,동면,장동리2,99,210,89,121,2025-07-31
2009,동면,운농리1,89,187,94,93,2025-07-31
2009,동면,운농리2,79,157,93,64,2025-07-31
2009,동면,운농리3,76,162,86,76,2025-07-31
2009,동면,옥호리1,30,46,22,24,2025-07-31
2009,동면,옥호리2,34,57,28,29,2025-07-31
2009,동면,옥호리3,16,31,15,16,2025-07-31
2009,동면,대포리1,71,135,75,60,2025-07-31
2009,동면,대포리2,40,83,41,42,2025-07-31
2009,동면,대포리3,65,132,66,66,2025-07-31
2010,화순읍,감도리1반,59,116,64,52,2025-07-31
2010,화순읍,감도리2반,41,96,49,47,2025-07-31
2010,화순읍,감도리3반,19,44,23,21,2025-07-31
2010,화순읍,강정리1반,6,13,8,5,2025-07-31
2010,화순읍,계소리1반,158,432,216,216,2025-07-31
2010,화순읍,계소리2반,21,36,20,16,2025-07-31
2010,화순읍,계소리3반,46,124,65,59,2025-07-31
2010,화순읍,계소리4반,267,646,331,315,2025-07-31
2010,화순읍,광덕리1반,305,725,377,348,2025-07-31
2010,화순읍,광덕리2반,195,503,252,251,2025-07-31
2010,화순읍,광덕리3반,70,188,101,87,2025-07-31
2010,화순읍,광덕리4반,531,1707,833,874,2025-07-31
2010,화순읍,광덕리5반,452,1405,670,735,2025-07-31
2010,화순읍,교리1반,335,773,407,366,2025-07-31
2010,화순읍,교리2반,524,1681,808,873,2025-07-31
2010,화순읍,교리3반,184,479,252,227,2025-07-31
2010,화순읍,내평리1반,116,259,133,126,2025-07-31
2010,화순읍,다지리1반,80,225,118,107,2025-07-31
2010,화순읍,다지리2반,70,158,73,85,2025-07-31
2010,화순읍,대리1반,329,853,429,424,2025-07-31
2010,화순읍,대리2반,62,140,67,73,2025-07-31
2010,화순읍,대리3반,54,142,77,65,2025-07-31
2010,화순읍,대리4반,285,837,395,442,2025-07-31
2010,화순읍,대리5반,433,1176,578,598,2025-07-31
2010,화순읍,대리6반,392,1288,636,652,2025-07-31
2010,화순읍,대리7반,419,919,425,494,2025-07-31
2010,화순읍,도웅리1반,75,150,70,80,2025-07-31
2010,화순읍,도웅리2반,25,41,17,24,2025-07-31
2010,화순읍,동구리1반,35,72,35,37,2025-07-31
2010,화순읍,만연리1반,134,328,177,151,2025-07-31
2010,화순읍,만연리2반,153,355,181,174,2025-07-31
2010,화순읍,만연리3반,894,2483,1158,1325,2025-07-31
2010,화순읍,만연리4반,513,1649,794,855,2025-07-31
2010,화순읍,만연리5반,1040,2692,1272,1420,2025-07-31
2010,화순읍,만연리6반,911,2460,1194,1266,2025-07-31
2010,화순읍,벽라리1반,98,227,107,120,2025-07-31
2010,화순읍,벽라리2반,149,317,158,159,2025-07-31
2010,화순읍,벽라리3반,390,1127,565,562,2025-07-31
2010,화순읍,삼천리1반,107,238,117,121,2025-07-31
2010,화순읍,삼천리2반,84,213,119,94,2025-07-31
2010,화순읍,삼천리3반,31,72,41,31,2025-07-31
2010,화순읍,삼천리4반,453,820,443,377,2025-07-31
2010,화순읍,서태리1반,83,184,101,83,2025-07-31
2010,화순읍,서태리2반,54,99,47,52,2025-07-31
2010,화순읍,세량리1반,47,93,48,45,2025-07-31
2010,화순읍,수만리1반,39,76,42,34,2025-07-31
2010,화순읍,수만리2반,29,57,32,25,2025-07-31
2010,화순읍,수만리3반,52,100,59,41,2025-07-31
2010,화순읍,신기리1반,397,938,497,441,2025-07-31
2010,화순읍,신기리2반,1284,3678,1835,1843,2025-07-31
2010,화순읍,신기리3반,229,580,285,295,2025-07-31
2010,화순읍,앵남리1반,49,97,51,46,2025-07-31
2010,화순읍,앵남리2반,57,100,51,49,2025-07-31
2010,화순읍,연양리1반,51,113,58,55,2025-07-31
2010,화순읍,연양리2반,92,196,107,89,2025-07-31
2010,화순읍,유천리1반,57,139,70,69,2025-07-31
2010,화순읍,유천리2반,42,93,45,48,2025-07-31
2010,화순읍,유천리3반,40,85,41,44,2025-07-31
2010,화순읍,이십곡리,76,161,80,81,2025-07-31
2010,화순읍,이십곡리,44,100,52,48,2025-07-31
2010,화순읍,일심리1반,191,493,257,236,2025-07-31
2010,화순읍,일심리2반,46,98,46,52,2025-07-31
2010,화순읍,일심리3반,42,102,53,49,2025-07-31
2010,화순읍,일심리4반,434,1195,579,616,2025-07-31
2010,화순읍,일심리5반,545,1460,715,745,2025-07-31
2010,화순읍,일심리6반,657,2102,1013,1089,2025-07-31
2010,화순읍,주도리1반,35,58,33,25,2025-07-31
2010,화순읍,주도리2반,67,120,54,66,2025-07-31
2010,화순읍,주도리3반,45,80,39,41,2025-07-31
2010,화순읍,향청리1반,295,688,359,329,2025-07-31
2010,화순읍,훈리1반,192,451,232,219,2025-07-31
2010,한천면,모산1,97,206,97,109,2025-07-31
2010,한천면,모산2,23,39,20,19,2025-07-31
2010,한천면,금전리,77,133,64,69,2025-07-31
2010,한천면,한계1,115,231,111,120,2025-07-31
2010,한천면,한계2,56,126,59,67,2025-07-31
2010,한천면,정리1,20,31,20,11,2025-07-31
2010,한천면,정리2,31,78,40,38,2025-07-31
2010,한천면,가암1,33,59,30,29,2025-07-31
2010,한천면,가암2,35,62,23,39,2025-07-31
2010,한천면,오음1,38,79,37,42,2025-07-31
2010,한천면,오음2,21,47,25,22,2025-07-31
2010,한천면,오음3,34,53,32,21,2025-07-31
2010,한천면,반곡1,32,62,32,30,2025-07-31
2010,한천면,반곡2,42,70,38,32,2025-07-31
2010,한천면,평리,50,111,56,55,2025-07-31
2010,한천면,정우리,42,77,35,42,2025-07-31
2010,한천면,동가1,69,135,67,68,2025-07-31
2010,한천면,동가2,39,83,43,40,2025-07-31
2010,한천면,고시리,6,11,8,3,2025-07-31
2010,춘양면,석정리,259,516,267,249,2025-07-31
2010,춘양면,화림리1,31,59,24,35,2025-07-31
2010,춘양면,화림리2,58,103,54,49,2025-07-31
2010,춘양면,화림리3,36,65,27,38,2025-07-31
2010,춘양면,대신리1,33,81,42,39,2025-07-31
2010,춘양면,대신리2,27,48,24,24,2025-07-31
2010,춘양면,대신리3,28,46,25,21,2025-07-31
2010,춘양면,회송리1,35,64,29,35,2025-07-31
2010,춘양면,회송리2,29,51,30,21,2025-07-31
2010,춘양면,양곡리1,49,106,58,48,2025-07-31
2010,춘양면,용곡리1,56,97,50,47,2025-07-31
2010,춘양면,월평리1,41,88,40,48,2025-07-31
2010,춘양면,월평리2,27,45,22,23,2025-07-31
2010,춘양면,월평리3,20,36,19,17,2025-07-31
2010,춘양면,변천리1,54,104,49,55,2025-07-31
2010,춘양면,가동리1,10,15,8,7,2025-07-31
2010,춘양면,산간리1,60,118,53,65,2025-07-31
2010,춘양면,가봉리1,77,154,75,79,2025-07-31
2010,춘양면,용두리1,41,71,31,40,2025-07-31
2010,춘양면,우봉리1,71,219,94,125,2025-07-31
2010,춘양면,부곡리1,25,48,21,27,2025-07-31
2010,춘양면,부곡리2,35,68,33,35,2025-07-31
2010,춘양면,부곡리3,28,55,32,23,2025-07-31
2010,청풍면,풍암리1,78,153,72,81,2025-07-31
2010,청풍면,한지리1,39,72,40,32,2025-07-31
2010,청풍면,한지리2,30,56,23,33,2025-07-31
2010,청풍면,어리1,47,80,39,41,2025-07-31
2010,청풍면,세청리1,67,120,61,59,2025-07-31
2010,청풍면,세청리2,18,25,10,15,2025-07-31
2010,청풍면,대비리1,45,84,47,37,2025-07-31
2010,청풍면,백운리1,37,73,35,38,2025-07-31
2010,청풍면,청용리1,33,55,26,29,2025-07-31
2010,청풍면,이만리1,19,28,16,12,2025-07-31
2010,청풍면,신석리1,20,34,15,19,2025-07-31
2010,청풍면,신석리2,26,45,23,22,2025-07-31
2010,청풍면,신리1,57,101,54,47,2025-07-31
2010,청풍면,신리2,39,78,45,33,2025-07-31
2010,청풍면,차리1,32,55,19,36,2025-07-31
2010,청풍면,차리2,111,234,110,124,2025-07-31
2010,이양면,금능1,90,213,95,118,2025-07-31
2010,이양면,강성리1,49,76,32,44,2025-07-31
2010,이양면,강성리2,32,67,36,31,2025-07-31
2010,이양면,강성리3,35,62,32,30,2025-07-31
2010,이양면,용반리1,32,49,20,29,2025-07-31
2010,이양면,장치리1,18,37,16,21,2025-07-31
2010,이양면,묵곡리1,25,41,19,22,2025-07-31
2010,이양면,묵곡리2,35,77,34,43,2025-07-31
2010,이양면,옥리1,19,38,17,21,2025-07-31
2010,이양면,품평리1,49,88,41,47,2025-07-31
2010,이양면,품평리2,38,102,51,51,2025-07-31
2010,이양면,품평리3,42,83,40,43,2025-07-31
2010,이양면,오류리1,97,200,96,104,2025-07-31
2010,이양면,오류리2,39,84,44,40,2025-07-31
2010,이양면,오류리3,53,101,46,55,2025-07-31
2010,이양면,오류리4,29,53,28,25,2025-07-31
2010,이양면,이양리1,48,88,36,52,2025-07-31
2010,이양면,이양리2,61,139,66,73,2025-07-31
2010,이양면,율계리1,45,80,43,37,2025-07-31
2010,이양면,송정리1,23,38,18,20,2025-07-31
2010,이양면,송정리2,28,52,32,20,2025-07-31
2010,이양면,초방리1,25,43,21,22,2025-07-31
2010,이양면,초방리2,26,44,19,25,2025-07-31
2010,이양면,매정리1,25,51,25,26,2025-07-31
2010,이양면,매정리2,28,62,30,32,2025-07-31
2010,이양면,연화리1,27,51,31,20,2025-07-31
2010,이양면,구례리1,34,60,30,30,2025-07-31
2010,이양면,쌍봉리1,76,140,66,74,2025-07-31
2010,이양면,증리1,21,37,19,18,2025-07-31
2010,능주면,남정리1,145,300,155,145,2025-07-31
2010,능주면,남정리2,35,57,22,35,2025-07-31
2010,능주면,정남리1,85,196,96,100,2025-07-31
2010,능주면,석고리1,214,454,230,224,2025-07-31
2010,능주면,잠정리1,216,539,268,271,2025-07-31
2010,능주면,내리1,33,71,41,30,2025-07-31
2010,능주면,관영리1,290,698,341,357,2025-07-31
2010,능주면,천덕리1,62,126,63,63,2025-07-31
2010,능주면,천덕리2,43,95,41,54,2025-07-31
2010,능주면,만인리1,69,155,79,76,2025-07-31
2010,능주면,광사리1,42,98,57,41,2025-07-31
2010,능주면,백암리1,97,198,100,98,2025-07-31
2010,능주면,백암리2,53,106,54,52,2025-07-31
2010,능주면,만수리1,74,181,93,88,2025-07-31
2010,능주면,만수리2,53,126,63,63,2025-07-31
2010,능주면,원지리1,97,194,90,104,2025-07-31
2010,도곡면,대곡리1반,38,83,41,42,2025-07-31
2010,도곡면,대곡리2반,53,104,55,49,2025-07-31
2010,도곡면,대곡리3반,57,114,58,56,2025-07-31
2010,도곡면,효산리1반,134,306,152,154,2025-07-31
2010,도곡면,효산리2반,70,150,70,80,2025-07-31
2010,도곡면,월곡리1반,42,76,33,43,2025-07-31
2010,도곡면,월곡리2반,49,90,41,49,2025-07-31
2010,도곡면,월곡리3반,30,62,35,27,2025-07-31
2010,도곡면,쌍옥리1반,81,167,81,86,2025-07-31
2010,도곡면,쌍옥리2반,60,109,57,52,2025-07-31
2010,도곡면,평리1반,78,164,83,81,2025-07-31
2010,도곡면,덕곡리1반,38,61,24,37,2025-07-31
2010,도곡면,덕곡리2반,34,85,45,40,2025-07-31
2010,도곡면,신성리1반,48,97,46,51,2025-07-31
2010,도곡면,신성리2반,48,98,45,53,2025-07-31
2010,도곡면,천암리1반,204,472,243,229,2025-07-31
2010,도곡면,원화리1반,78,150,81,69,2025-07-31
2010,도곡면,원화리2반,48,86,43,43,2025-07-31
2010,도곡면,신덕리1반,51,100,49,51,2025-07-31
2010,도곡면,신덕리2반,41,68,31,37,2025-07-31
2010,도곡면,신덕리3반,32,62,31,31,2025-07-31
2010,도곡면,미곡리1반,32,69,36,33,2025-07-31
2010,도곡면,미곡리2반,46,89,42,47,2025-07-31
2010,도곡면,족청리1반,81,181,97,84,2025-07-31
2010,도곡면,족청리2반,25,41,19,22,2025-07-31
2010,도암면,운월리1,31,59,27,32,2025-07-31
2010,도암면,운월리2,33,60,33,27,2025-07-31
2010,도암면,도장리1,67,155,74,81,2025-07-31
2010,도암면,벽지리1,35,56,22,34,2025-07-31
2010,도암면,벽지리1,23,57,32,25,2025-07-31
2010,도암면,정천리1,76,137,78,59,2025-07-31
2010,도암면,원천리1,46,85,42,43,2025-07-31
2010,도암면,원천리2,23,56,30,26,2025-07-31
2010,도암면,원천리3,63,110,56,54,2025-07-31
2010,도암면,천태리1,31,63,35,28,2025-07-31
2010,도암면,천태리2,32,66,31,35,2025-07-31
2010,도암면,지월리1,19,50,26,24,2025-07-31
2010,도암면,지월리2,50,95,48,47,2025-07-31
2010,도암면,등광리1,54,91,48,43,2025-07-31
2010,도암면,대초리1,35,69,31,38,2025-07-31
2010,도암면,용강리1,54,89,47,42,2025-07-31
2010,도암면,용강리2,30,52,29,23,2025-07-31
2010,도암면,용강리3,45,100,56,44,2025-07-31
2010,도암면,호암리1,22,39,23,16,2025-07-31
2010,도암면,호암리2,25,42,20,22,2025-07-31
2010,도암면,우치리1,26,38,15,23,2025-07-31
2010,도암면,봉하리1,24,41,21,20,2025-07-31
2010,도암면,왕정리1,6,10,5,5,2025-07-31
2010,도암면,행산리1,9,20,9,11,2025-07-31
2010,이서면,"서리,월산리1",15,26,16,10,2025-07-31
2010,이서면,창랑리1,39,54,25,29,2025-07-31
2010,이서면,야사리1,63,125,65,60,2025-07-31
2010,이서면,야사리2,56,111,54,57,2025-07-31
2010,이서면,야사리3,24,54,24,30,2025-07-31
2010,이서면,야사리4,34,52,24,28,2025-07-31
2010,이서면,보월리1,69,146,73,73,2025-07-31
2010,이서면,보월리2,21,36,20,16,2025-07-31
2010,이서면,인계리1,45,76,32,44,2025-07-31
2010,이서면,인계리2,26,56,29,27,2025-07-31
2010,이서면,영평리1,84,148,71,77,2025-07-31
2010,이서면,안심리1,57,112,55,57,2025-07-31
2010,이서면,안심리2,24,44,28,16,2025-07-31
2010,이서면,갈두리1,6,13,8,5,2025-07-31
2010,백아면,임곡리1,62,130,66,64,2025-07-31
2010,백아면,옥리1구1,58,115,57,58,2025-07-31
2010,백아면,옥리2구2,32,56,27,29,2025-07-31
2010,백아면,서유리1구1,60,118,60,58,2025-07-31
2010,백아면,서유리2구2,26,53,26,27,2025-07-31
2010,백아면,맹리1,39,65,35,30,2025-07-31
2010,백아면,남치리1,52,107,49,58,2025-07-31
2010,백아면,원리1,114,230,113,117,2025-07-31
2010,백아면,송단리1구1,36,68,34,34,2025-07-31
2010,백아면,송단리2구2,38,70,34,36,2025-07-31
2010,백아면,방리1,32,62,31,31,2025-07-31
2010,백아면,노기리1,32,79,40,39,2025-07-31
2010,백아면,이천리1구1,51,100,48,52,2025-07-31
2010,백아면,이천리2구2,81,143,68,75,2025-07-31
2010,백아면,길성리1,59,91,41,50,2025-07-31
2010,백아면,와천리1,19,41,18,23,2025-07-31
2010,백아면,다곡리1,70,116,50,66,2025-07-31
2010,백아면,수리1,86,167,77,90,2025-07-31
2010,백아면,노치리1,19,57,32,25,2025-07-31
2010,백아면,용곡리1구1,39,62,30,32,2025-07-31
2010,백아면,용곡리2구2,22,33,15,18,2025-07-31
2010,동복면,독상리1,132,264,131,133,2025-07-31
2010,동복면,칠정리1,63,118,62,56,2025-07-31
2010,동복면,칠정리2,33,66,26,40,2025-07-31
2010,동복면,천변리1,103,240,118,122,2025-07-31
2010,동복면,유천리1,78,140,74,66,2025-07-31
2010,동복면,신율리1,43,86,46,40,2025-07-31
2010,동복면,신율리2,23,50,25,25,2025-07-31
2010,동복면,신율리3,29,59,26,33,2025-07-31
2010,동복면,가수리1,45,96,46,50,2025-07-31
2010,동복면,가수리2,18,40,14,26,2025-07-31
2010,동복면,가수리3,22,34,15,19,2025-07-31
2010,동복면,안성리1,65,127,66,61,2025-07-31
2010,동복면,연월리1,50,87,36,51,2025-07-31
2010,동복면,연월리2,31,52,23,29,2025-07-31
2010,동복면,연월리3,33,66,34,32,2025-07-31
2010,동복면,읍애리1,36,64,32,32,2025-07-31
2010,동복면,연둔리1,40,62,26,36,2025-07-31
2010,동복면,연둔리2,23,37,16,21,2025-07-31
2010,동복면,구암리1,32,80,39,41,2025-07-31
2010,동복면,구암리2,32,61,32,29,2025-07-31
2010,동복면,한천리1,111,199,92,107,2025-07-31
2010,사평면,사평리1,57,115,62,53,2025-07-31
2010,사평면,사평리2,76,171,86,85,2025-07-31
2010,사평면,사평리3,59,143,77,66,2025-07-31
2010,사평면,사평리4,68,166,81,85,2025-07-31
2010,사평면,사평리5,78,142,65,77,2025-07-31
2010,사평면,대곡리1,45,99,43,56,2025-07-31
2010,사평면,대곡리2,20,38,20,18,2025-07-31
2010,사평면,검산리1,46,92,53,39,2025-07-31
2010,사평면,검산리2,21,40,20,20,2025-07-31
2010,사평면,운산리1,35,58,31,27,2025-07-31
2010,사평면,원리1,48,102,44,58,2025-07-31
2010,사평면,원리2,35,63,33,30,2025-07-31
2010,사평면,벽송리1,103,218,107,111,2025-07-31
2010,사평면,벽송리2,27,50,24,26,2025-07-31
2010,사평면,장전리1,52,114,53,61,2025-07-31
2010,사평면,장전리2,29,69,36,33,2025-07-31
2010,사평면,절산리1,76,144,67,77,2025-07-31
2010,사평면,절산리2,41,69,35,34,2025-07-31
2010,사평면,사수리1,28,66,35,31,2025-07-31
2010,사평면,사수리2,26,46,23,23,2025-07-31
2010,사평면,주산리1,27,58,30,28,2025-07-31
2010,사평면,복교리1,10,21,11,10,2025-07-31
2010,사평면,남계리1,52,87,40,47,2025-07-31
2010,사평면,남계리2,3,4,1,3,2025-07-31
2010,사평면,유마리1,22,41,18,23,2025-07-31
2010,사평면,다산리1,51,104,52,52,2025-07-31
2010,사평면,용리1,22,37,17,20,2025-07-31
2010,사평면,용리2,46,92,46,46,2025-07-31
2010,사평면,내리1,33,56,25,31,2025-07-31
2010,사평면,내리2,23,45,22,23,2025-07-31
2010,사평면,내리3,33,79,48,31,2025-07-31
2010,동면,백용리1,38,98,48,50,2025-07-31
2010,동면,백용리2,77,179,94,85,2025-07-31
2010,동면,언도리1,60,104,48,56,2025-07-31
2010,동면,언도리2,44,113,53,60,2025-07-31
2010,동면,서성리1,32,56,28,28,2025-07-31
2010,동면,서성리2,27,62,33,29,2025-07-31
2010,동면,국동리1,33,55,29,26,2025-07-31
2010,동면,청궁리2,61,109,54,55,2025-07-31
2010,동면,마산리1,42,93,48,45,2025-07-31
2010,동면,무포리1,38,72,36,36,2025-07-31
2010,동면,무포리2,22,40,21,19,2025-07-31
2010,동면,경치리1,49,90,43,47,2025-07-31
2010,동면,경치리2,15,43,17,26,2025-07-31
2010,동면,복암리1,74,116,58,58,2025-07-31
2010,동면,복암리2,159,289,157,132,2025-07-31
2010,동면,복암리3,56,92,41,51,2025-07-31
2010,동면,오동리1,141,319,165,154,2025-07-31
2010,동면,오동리2,35,67,40,27,2025-07-31
2010,동면,오동리3,58,115,58,57,2025-07-31
2010,동면,천덕리1,49,93,50,43,2025-07-31
2010,동면,천덕리2,41,94,51,43,2025-07-31
2010,동면,천덕리3,68,145,76,69,2025-07-31
2010,동면,장동리1,134,290,137,153,2025-07-31
2010,동면,장동리2,91,199,84,115,2025-07-31
2010,동면,운농리1,86,172,94,78,2025-07-31
2010,동면,운농리2,89,169,104,65,2025-07-31
2010,동면,운농리3,77,156,80,76,2025-07-31
2010,동면,옥호리1,33,53,27,26,2025-07-31
2010,동면,옥호리2,31,55,28,27,2025-07-31
2010,동면,옥호리3,16,30,14,16,2025-07-31
2010,동면,대포리1,74,141,74,67,2025-07-31
2010,동면,대포리2,41,93,44,49,2025-07-31
2010,동면,대포리3,61,131,66,65,2025-07-31
2011,화순읍,감도리1반,57,119,64,55,2025-07-31
2011,화순읍,감도리2반,41,99,50,49,2025-07-31
2011,화순읍,감도리3반,18,43,21,22,2025-07-31
2011,화순읍,강정리1반,6,12,7,5,2025-07-31
2011,화순읍,계소리1반,168,446,221,225,2025-07-31
2011,화순읍,계소리2반,19,35,19,16,2025-07-31
2011,화순읍,계소리3반,43,109,60,49,2025-07-31
2011,화순읍,계소리4반,262,631,319,312,2025-07-31
2011,화순읍,광덕리1반,297,724,364,360,2025-07-31
2011,화순읍,광덕리2반,192,463,235,228,2025-07-31
2011,화순읍,광덕리3반,70,182,96,86,2025-07-31
2011,화순읍,광덕리4반,539,1677,826,851,2025-07-31
2011,화순읍,광덕리5반,464,1466,709,757,2025-07-31
2011,화순읍,교리1반,321,711,376,335,2025-07-31
2011,화순읍,교리2반,534,1716,837,879,2025-07-31
2011,화순읍,교리3반,184,459,240,219,2025-07-31
2011,화순읍,내평리1반,113,247,127,120,2025-07-31
2011,화순읍,다지리1반,78,222,117,105,2025-07-31
2011,화순읍,다지리2반,81,175,85,90,2025-07-31
2011,화순읍,대리1반,374,966,482,484,2025-07-31
2011,화순읍,대리2반,58,137,63,74,2025-07-31
2011,화순읍,대리3반,55,141,74,67,2025-07-31
2011,화순읍,대리4반,411,1251,580,671,2025-07-31
2011,화순읍,대리5반,435,1168,563,605,2025-07-31
2011,화순읍,대리6반,397,1306,653,653,2025-07-31
2011,화순읍,대리7반,426,898,434,464,2025-07-31
2011,화순읍,도웅리1반,74,136,65,71,2025-07-31
2011,화순읍,도웅리2반,24,37,16,21,2025-07-31
2011,화순읍,동구리1반,35,70,37,33,2025-07-31
2011,화순읍,만연리1반,119,295,160,135,2025-07-31
2011,화순읍,만연리2반,144,331,169,162,2025-07-31
2011,화순읍,만연리3반,911,2500,1158,1342,2025-07-31
2011,화순읍,만연리4반,515,1648,795,853,2025-07-31
2011,화순읍,만연리5반,1041,2739,1296,1443,2025-07-31
2011,화순읍,만연리6반,894,2428,1163,1265,2025-07-31
2011,화순읍,벽라리1반,101,232,107,125,2025-07-31
2011,화순읍,벽라리2반,146,307,152,155,2025-07-31
2011,화순읍,벽라리3반,388,1102,540,562,2025-07-31
2011,화순읍,삼천리1반,107,234,110,124,2025-07-31
2011,화순읍,삼천리2반,79,198,110,88,2025-07-31
2011,화순읍,삼천리3반,33,68,38,30,2025-07-31
2011,화순읍,삼천리4반,466,798,433,365,2025-07-31
2011,화순읍,서태리1반,84,173,97,76,2025-07-31
2011,화순읍,서태리2반,55,98,47,51,2025-07-31
2011,화순읍,세량리1반,48,95,48,47,2025-07-31
2011,화순읍,수만리1반,42,75,43,32,2025-07-31
2011,화순읍,수만리2반,24,42,24,18,2025-07-31
2011,화순읍,수만리3반,52,100,59,41,2025-07-31
2011,화순읍,신기리1반,378,852,471,381,2025-07-31
2011,화순읍,신기리2반,1314,3747,1860,1887,2025-07-31
2011,화순읍,신기리3반,228,556,278,278,2025-07-31
2011,화순읍,앵남리1반,49,98,50,48,2025-07-31
2011,화순읍,앵남리2반,54,95,49,46,2025-07-31
2011,화순읍,연양리1반,51,119,64,55,2025-07-31
2011,화순읍,연양리2반,91,196,107,89,2025-07-31
2011,화순읍,유천리1반,57,140,72,68,2025-07-31
2011,화순읍,유천리2반,40,97,46,51,2025-07-31
2011,화순읍,유천리3반,42,90,44,46,2025-07-31
2011,화순읍,이십곡리,75,152,80,72,2025-07-31
2011,화순읍,이십곡리,43,92,49,43,2025-07-31
2011,화순읍,일심리1반,191,471,239,232,2025-07-31
2011,화순읍,일심리2반,44,115,60,55,2025-07-31
2011,화순읍,일심리3반,49,113,56,57,2025-07-31
2011,화순읍,일심리4반,428,1219,575,644,2025-07-31
2011,화순읍,일심리5반,538,1438,713,725,2025-07-31
2011,화순읍,일심리6반,649,2080,1014,1066,2025-07-31
2011,화순읍,주도리1반,36,62,34,28,2025-07-31
2011,화순읍,주도리2반,61,115,53,62,2025-07-31
2011,화순읍,주도리3반,44,85,45,40,2025-07-31
2011,화순읍,향청리1반,285,641,338,303,2025-07-31
2011,화순읍,훈리1반,173,421,224,197,2025-07-31
2011,한천면,모산1,99,206,100,106,2025-07-31
2011,한천면,모산2,24,41,24,17,2025-07-31
2011,한천면,금전리,52,108,55,53,2025-07-31
2011,한천면,한계1,113,233,115,118,2025-07-31
2011,한천면,한계2,60,126,62,64,2025-07-31
2011,한천면,정리1,23,29,19,10,2025-07-31
2011,한천면,정리2,29,74,36,38,2025-07-31
2011,한천면,가암1,35,59,26,33,2025-07-31
2011,한천면,가암2,36,69,28,41,2025-07-31
2011,한천면,오음1,36,78,36,42,2025-07-31
2011,한천면,오음2,21,51,26,25,2025-07-31
2011,한천면,오음3,30,47,25,22,2025-07-31
2011,한천면,반곡1,34,64,34,30,2025-07-31
2011,한천면,반곡2,41,67,36,31,2025-07-31
2011,한천면,평리,46,96,48,48,2025-07-31
2011,한천면,정우리,44,82,37,45,2025-07-31
2011,한천면,동가1,71,137,68,69,2025-07-31
2011,한천면,동가2,39,76,37,39,2025-07-31
2011,한천면,고시리,6,11,7,4,2025-07-31
2011,춘양면,석정리,256,505,270,235,2025-07-31
2011,춘양면,화림리1,27,54,22,32,2025-07-31
2011,춘양면,화림리2,58,105,52,53,2025-07-31
2011,춘양면,화림리3,37,70,29,41,2025-07-31
2011,춘양면,대신리1,33,71,37,34,2025-07-31
2011,춘양면,대신리2,25,45,22,23,2025-07-31
2011,춘양면,대신리3,28,48,28,20,2025-07-31
2011,춘양면,회송리1,33,67,29,38,2025-07-31
2011,춘양면,회송리2,30,51,31,20,2025-07-31
2011,춘양면,양곡리1,50,111,60,51,2025-07-31
2011,춘양면,용곡리1,54,93,48,45,2025-07-31
2011,춘양면,월평리1,40,85,40,45,2025-07-31
2011,춘양면,월평리2,27,51,27,24,2025-07-31
2011,춘양면,월평리3,18,34,17,17,2025-07-31
2011,춘양면,변천리1,54,102,47,55,2025-07-31
2011,춘양면,가동리1,11,17,8,9,2025-07-31
2011,춘양면,산간리1,58,114,52,62,2025-07-31
2011,춘양면,가봉리1,76,154,74,80,2025-07-31
2011,춘양면,용두리1,42,72,31,41,2025-07-31
2011,춘양면,우봉리1,71,203,93,110,2025-07-31
2011,춘양면,부곡리1,24,47,21,26,2025-07-31
2011,춘양면,부곡리2,35,62,32,30,2025-07-31
2011,춘양면,부곡리3,25,54,30,24,2025-07-31
2011,청풍면,풍암리1,77,147,67,80,2025-07-31
2011,청풍면,한지리1,41,72,35,37,2025-07-31
2011,청풍면,한지리2,29,56,24,32,2025-07-31
2011,청풍면,어리1,47,85,41,44,2025-07-31
2011,청풍면,세청리1,62,115,53,62,2025-07-31
2011,청풍면,세청리2,17,23,9,14,2025-07-31
2011,청풍면,대비리1,50,89,47,42,2025-07-31
2011,청풍면,백운리1,35,68,29,39,2025-07-31
2011,청풍면,청용리1,33,54,26,28,2025-07-31
2011,청풍면,이만리1,19,29,15,14,2025-07-31
2011,청풍면,신석리1,23,41,18,23,2025-07-31
2011,청풍면,신석리2,26,42,22,20,2025-07-31
2011,청풍면,신리1,54,98,52,46,2025-07-31
2011,청풍면,신리2,41,78,44,34,2025-07-31
2011,청풍면,차리1,29,52,20,32,2025-07-31
2011,청풍면,차리2,106,217,99,118,2025-07-31
2011,이양면,금능1,88,209,97,112,2025-07-31
2011,이양면,강성리1,47,63,23,40,2025-07-31
2011,이양면,강성리2,29,60,30,30,2025-07-31
2011,이양면,강성리3,30,57,30,27,2025-07-31
2011,이양면,용반리1,33,54,24,30,2025-07-31
2011,이양면,장치리1,21,36,15,21,2025-07-31
2011,이양면,묵곡리1,25,38,17,21,2025-07-31
2011,이양면,묵곡리2,34,75,33,42,2025-07-31
2011,이양면,옥리1,18,39,16,23,2025-07-31
2011,이양면,품평리1,50,86,43,43,2025-07-31
2011,이양면,품평리2,38,100,51,49,2025-07-31
2011,이양면,품평리3,40,75,36,39,2025-07-31
2011,이양면,오류리1,95,201,99,102,2025-07-31
2011,이양면,오류리2,40,85,44,41,2025-07-31
2011,이양면,오류리3,47,97,47,50,2025-07-31
2011,이양면,오류리4,28,47,24,23,2025-07-31
2011,이양면,이양리1,58,98,41,57,2025-07-31
2011,이양면,이양리2,60,131,61,70,2025-07-31
2011,이양면,율계리1,43,75,38,37,2025-07-31
2011,이양면,송정리1,22,40,17,23,2025-07-31
2011,이양면,송정리2,28,50,31,19,2025-07-31
2011,이양면,초방리1,27,53,26,27,2025-07-31
2011,이양면,초방리2,26,45,19,26,2025-07-31
2011,이양면,매정리1,22,49,27,22,2025-07-31
2011,이양면,매정리2,32,66,30,36,2025-07-31
2011,이양면,연화리1,28,49,29,20,2025-07-31
2011,이양면,구례리1,33,59,29,30,2025-07-31
2011,이양면,쌍봉리1,79,144,67,77,2025-07-31
2011,이양면,증리1,21,37,18,19,2025-07-31
2011,능주면,남정리1,138,295,156,139,2025-07-31
2011,능주면,남정리2,32,51,19,32,2025-07-31
2011,능주면,정남리1,81,191,92,99,2025-07-31
2011,능주면,석고리1,207,448,225,223,2025-07-31
2011,능주면,잠정리1,215,539,275,264,2025-07-31
2011,능주면,내리1,32,71,41,30,2025-07-31
2011,능주면,관영리1,277,653,319,334,2025-07-31
2011,능주면,천덕리1,62,122,58,64,2025-07-31
2011,능주면,천덕리2,46,98,44,54,2025-07-31
2011,능주면,만인리1,65,152,79,73,2025-07-31
2011,능주면,광사리1,42,96,54,42,2025-07-31
2011,능주면,백암리1,97,188,94,94,2025-07-31
2011,능주면,백암리2,49,95,46,49,2025-07-31
2011,능주면,만수리1,68,159,82,77,2025-07-31
2011,능주면,만수리2,47,118,55,63,2025-07-31
2011,능주면,원지리1,95,196,90,106,2025-07-31
2011,도곡면,대곡리1반,40,90,47,43,2025-07-31
2011,도곡면,대곡리2반,60,111,56,55,2025-07-31
2011,도곡면,대곡리3반,61,121,62,59,2025-07-31
2011,도곡면,효산리1반,141,300,152,148,2025-07-31
2011,도곡면,효산리2반,73,150,72,78,2025-07-31
2011,도곡면,월곡리1반,41,74,31,43,2025-07-31
2011,도곡면,월곡리2반,47,97,45,52,2025-07-31
2011,도곡면,월곡리3반,33,72,42,30,2025-07-31
2011,도곡면,쌍옥리1반,79,163,74,89,2025-07-31
2011,도곡면,쌍옥리2반,56,96,51,45,2025-07-31
2011,도곡면,평리1반,83,165,83,82,2025-07-31
2011,도곡면,덕곡리1반,39,60,25,35,2025-07-31
2011,도곡면,덕곡리2반,33,82,45,37,2025-07-31
2011,도곡면,신성리1반,47,90,44,46,2025-07-31
2011,도곡면,신성리2반,51,98,40,58,2025-07-31
2011,도곡면,천암리1반,213,486,249,237,2025-07-31
2011,도곡면,원화리1반,78,159,85,74,2025-07-31
2011,도곡면,원화리2반,45,83,39,44,2025-07-31
2011,도곡면,신덕리1반,54,103,50,53,2025-07-31
2011,도곡면,신덕리2반,39,61,24,37,2025-07-31
2011,도곡면,신덕리3반,32,57,31,26,2025-07-31
2011,도곡면,미곡리1반,34,69,34,35,2025-07-31
2011,도곡면,미곡리2반,48,92,44,48,2025-07-31
2011,도곡면,족청리1반,78,176,93,83,2025-07-31
2011,도곡면,족청리2반,24,41,19,22,2025-07-31
2011,도암면,운월리1,32,59,29,30,2025-07-31
2011,도암면,운월리2,35,55,28,27,2025-07-31
2011,도암면,도장리1,65,153,72,81,2025-07-31
2011,도암면,벽지리1,36,56,24,32,2025-07-31
2011,도암면,벽지리1,22,57,33,24,2025-07-31
2011,도암면,정천리1,76,132,76,56,2025-07-31
2011,도암면,원천리1,48,96,50,46,2025-07-31
2011,도암면,원천리2,23,49,28,21,2025-07-31
2011,도암면,원천리3,62,108,54,54,2025-07-31
2011,도암면,천태리1,34,66,36,30,2025-07-31
2011,도암면,천태리2,33,66,30,36,2025-07-31
2011,도암면,지월리1,18,44,23,21,2025-07-31
2011,도암면,지월리2,52,98,49,49,2025-07-31
2011,도암면,등광리1,51,86,47,39,2025-07-31
2011,도암면,대초리1,36,64,31,33,2025-07-31
2011,도암면,용강리1,51,83,42,41,2025-07-31
2011,도암면,용강리2,30,51,27,24,2025-07-31
2011,도암면,용강리3,48,106,57,49,2025-07-31
2011,도암면,호암리1,24,43,24,19,2025-07-31
2011,도암면,호암리2,21,36,18,18,2025-07-31
2011,도암면,우치리1,23,35,15,20,2025-07-31
2011,도암면,봉하리1,23,39,19,20,2025-07-31
2011,도암면,왕정리1,7,12,6,6,2025-07-31
2011,도암면,행산리1,9,21,8,13,2025-07-31
2011,이서면,"서리,월산리1",16,29,18,11,2025-07-31
2011,이서면,창랑리1,35,46,21,25,2025-07-31
2011,이서면,야사리1,66,128,60,68,2025-07-31
2011,이서면,야사리2,53,99,50,49,2025-07-31
2011,이서면,야사리3,23,50,23,27,2025-07-31
2011,이서면,야사리4,32,46,20,26,2025-07-31
2011,이서면,보월리1,65,134,65,69,2025-07-31
2011,이서면,보월리2,23,37,19,18,2025-07-31
2011,이서면,인계리1,44,72,31,41,2025-07-31
2011,이서면,인계리2,28,60,31,29,2025-07-31
2011,이서면,영평리1,85,160,79,81,2025-07-31
2011,이서면,안심리1,60,111,59,52,2025-07-31
2011,이서면,안심리2,22,42,26,16,2025-07-31
2011,이서면,갈두리1,5,8,6,2,2025-07-31
2011,백아면,임곡리1,62,125,63,62,2025-07-31
2011,백아면,옥리1구1,55,112,56,56,2025-07-31
2011,백아면,옥리2구2,30,51,26,25,2025-07-31
2011,백아면,서유리1구1,58,111,56,55,2025-07-31
2011,백아면,서유리2구2,25,53,28,25,2025-07-31
2011,백아면,맹리1,39,66,36,30,2025-07-31
2011,백아면,남치리1,52,104,50,54,2025-07-31
2011,백아면,원리1,115,225,109,116,2025-07-31
2011,백아면,송단리1구1,36,66,32,34,2025-07-31
2011,백아면,송단리2구2,41,77,38,39,2025-07-31
2011,백아면,방리1,28,59,31,28,2025-07-31
2011,백아면,노기리1,33,73,36,37,2025-07-31
2011,백아면,이천리1구1,51,101,47,54,2025-07-31
2011,백아면,이천리2구2,78,133,66,67,2025-07-31
2011,백아면,길성리1,57,88,39,49,2025-07-31
2011,백아면,와천리1,20,42,19,23,2025-07-31
2011,백아면,다곡리1,70,115,51,64,2025-07-31
2011,백아면,수리1,86,161,73,88,2025-07-31
2011,백아면,노치리1,19,57,32,25,2025-07-31
2011,백아면,용곡리1구1,38,62,30,32,2025-07-31
2011,백아면,용곡리2구2,21,33,16,17,2025-07-31
2011,동복면,독상리1,131,257,125,132,2025-07-31
2011,동복면,칠정리1,64,119,60,59,2025-07-31
2011,동복면,칠정리2,32,65,26,39,2025-07-31
2011,동복면,천변리1,99,229,111,118,2025-07-31
2011,동복면,유천리1,77,137,71,66,2025-07-31
2011,동복면,신율리1,37,80,42,38,2025-07-31
2011,동복면,신율리2,19,44,20,24,2025-07-31
2011,동복면,신율리3,27,51,20,31,2025-07-31
2011,동복면,가수리1,41,93,43,50,2025-07-31
2011,동복면,가수리2,17,39,14,25,2025-07-31
2011,동복면,가수리3,21,38,17,21,2025-07-31
2011,동복면,안성리1,65,122,65,57,2025-07-31
2011,동복면,연월리1,48,84,35,49,2025-07-31
2011,동복면,연월리2,30,52,22,30,2025-07-31
2011,동복면,연월리3,33,67,34,33,2025-07-31
2011,동복면,읍애리1,39,65,34,31,2025-07-31
2011,동복면,연둔리1,39,61,25,36,2025-07-31
2011,동복면,연둔리2,23,36,16,20,2025-07-31
2011,동복면,구암리1,31,70,32,38,2025-07-31
2011,동복면,구암리2,33,61,30,31,2025-07-31
2011,동복면,한천리1,113,194,86,108,2025-07-31
2011,사평면,사평리1,57,112,58,54,2025-07-31
2011,사평면,사평리2,75,159,81,78,2025-07-31
2011,사평면,사평리3,55,138,70,68,2025-07-31
2011,사평면,사평리4,64,149,78,71,2025-07-31
2011,사평면,사평리5,80,148,72,76,2025-07-31
2011,사평면,대곡리1,41,89,41,48,2025-07-31
2011,사평면,대곡리2,21,37,18,19,2025-07-31
2011,사평면,검산리1,44,87,50,37,2025-07-31
2011,사평면,검산리2,20,40,19,21,2025-07-31
2011,사평면,운산리1,37,60,32,28,2025-07-31
2011,사평면,원리1,50,109,49,60,2025-07-31
2011,사평면,원리2,33,57,30,27,2025-07-31
2011,사평면,벽송리1,106,219,109,110,2025-07-31
2011,사평면,벽송리2,26,47,22,25,2025-07-31
2011,사평면,장전리1,50,116,55,61,2025-07-31
2011,사평면,장전리2,33,76,38,38,2025-07-31
2011,사평면,절산리1,73,136,61,75,2025-07-31
2011,사평면,절산리2,42,68,34,34,2025-07-31
2011,사평면,사수리1,27,66,36,30,2025-07-31
2011,사평면,사수리2,27,46,23,23,2025-07-31
2011,사평면,주산리1,26,55,30,25,2025-07-31
2011,사평면,복교리1,9,19,10,9,2025-07-31
2011,사평면,남계리1,52,91,42,49,2025-07-31
2011,사평면,남계리2,3,5,2,3,2025-07-31
2011,사평면,유마리1,24,42,18,24,2025-07-31
2011,사평면,다산리1,53,106,52,54,2025-07-31
2011,사평면,용리1,22,36,18,18,2025-07-31
2011,사평면,용리2,42,81,42,39,2025-07-31
2011,사평면,내리1,31,58,24,34,2025-07-31
2011,사평면,내리2,24,48,23,25,2025-07-31
2011,사평면,내리3,33,76,46,30,2025-07-31
2011,동면,백용리1,40,101,51,50,2025-07-31
2011,동면,백용리2,79,185,94,91,2025-07-31
2011,동면,언도리1,58,107,50,57,2025-07-31
2011,동면,언도리2,47,108,49,59,2025-07-31
2011,동면,서성리1,29,50,26,24,2025-07-31
2011,동면,서성리2,31,65,38,27,2025-07-31
2011,동면,국동리1,36,59,32,27,2025-07-31
2011,동면,청궁리2,65,108,54,54,2025-07-31
2011,동면,마산리1,43,98,49,49,2025-07-31
2011,동면,무포리1,34,66,32,34,2025-07-31
2011,동면,무포리2,24,42,23,19,2025-07-31
2011,동면,경치리1,46,81,35,46,2025-07-31
2011,동면,경치리2,15,31,12,19,2025-07-31
2011,동면,복암리1,64,108,51,57,2025-07-31
2011,동면,복암리2,157,280,159,121,2025-07-31
2011,동면,복암리3,55,92,42,50,2025-07-31
2011,동면,오동리1,131,301,151,150,2025-07-31
2011,동면,오동리2,34,60,35,25,2025-07-31
2011,동면,오동리3,59,113,58,55,2025-07-31
2011,동면,천덕리1,51,107,58,49,2025-07-31
2011,동면,천덕리2,43,95,52,43,2025-07-31
2011,동면,천덕리3,66,147,71,76,2025-07-31
2011,동면,장동리1,151,287,143,144,2025-07-31
2011,동면,장동리2,89,205,88,117,2025-07-31
2011,동면,운농리1,86,176,98,78,2025-07-31
2011,동면,운농리2,82,158,98,60,2025-07-31
2011,동면,운농리3,75,147,80,67,2025-07-31
2011,동면,옥호리1,33,52,26,26,2025-07-31
2011,동면,옥호리2,34,52,26,26,2025-07-31
2011,동면,옥호리3,17,29,13,16,2025-07-31
2011,동면,대포리1,70,136,72,64,2025-07-31
2011,동면,대포리2,42,90,42,48,2025-07-31
2011,동면,대포리3,68,140,68,72,2025-07-31
2012,화순읍,감도리1반,63,138,74,64,2025-07-31
2012,화순읍,감도리2반,39,100,51,49,2025-07-31
2012,화순읍,감도리3반,18,47,23,24,2025-07-31
2012,화순읍,강정리1반,6,15,9,6,2025-07-31
2012,화순읍,계소리1반,176,458,222,236,2025-07-31
2012,화순읍,계소리2반,19,36,19,17,2025-07-31
2012,화순읍,계소리3반,46,120,68,52,2025-07-31
2012,화순읍,계소리4반,252,604,296,308,2025-07-31
2012,화순읍,광덕리1반,279,647,330,317,2025-07-31
2012,화순읍,광덕리2반,184,434,218,216,2025-07-31
2012,화순읍,광덕리3반,65,172,91,81,2025-07-31
2012,화순읍,광덕리4반,547,1694,837,857,2025-07-31
2012,화순읍,광덕리5반,464,1480,715,765,2025-07-31
2012,화순읍,교리1반,325,725,374,351,2025-07-31
2012,화순읍,교리2반,533,1682,835,847,2025-07-31
2012,화순읍,교리3반,186,444,227,217,2025-07-31
2012,화순읍,내평리1반,115,244,124,120,2025-07-31
2012,화순읍,다지리1반,84,234,123,111,2025-07-31
2012,화순읍,다지리2반,83,172,84,88,2025-07-31
2012,화순읍,대리1반,367,953,477,476,2025-07-31
2012,화순읍,대리2반,55,121,58,63,2025-07-31
2012,화순읍,대리3반,59,149,80,69,2025-07-31
2012,화순읍,대리4반,428,1307,606,701,2025-07-31
2012,화순읍,대리5반,423,1131,534,597,2025-07-31
2012,화순읍,대리6반,387,1274,642,632,2025-07-31
2012,화순읍,대리7반,406,849,402,447,2025-07-31
2012,화순읍,도웅리1반,78,147,76,71,2025-07-31
2012,화순읍,도웅리2반,22,33,14,19,2025-07-31
2012,화순읍,동구리1반,33,65,35,30,2025-07-31
2012,화순읍,만연리1반,114,284,157,127,2025-07-31
2012,화순읍,만연리2반,142,331,169,162,2025-07-31
2012,화순읍,만연리3반,919,2479,1162,1317,2025-07-31
2012,화순읍,만연리4반,516,1636,784,852,2025-07-31
2012,화순읍,만연리5반,1060,2777,1316,1461,2025-07-31
2012,화순읍,만연리6반,899,2424,1141,1283,2025-07-31
2012,화순읍,벽라리1반,98,217,104,113,2025-07-31
2012,화순읍,벽라리2반,134,276,135,141,2025-07-31
2012,화순읍,벽라리3반,378,1084,535,549,2025-07-31
2012,화순읍,삼천리1반,115,249,122,127,2025-07-31
2012,화순읍,삼천리2반,82,207,113,94,2025-07-31
2012,화순읍,삼천리3반,32,61,34,27,2025-07-31
2012,화순읍,삼천리4반,449,775,415,360,2025-07-31
2012,화순읍,서태리1반,86,182,102,80,2025-07-31
2012,화순읍,서태리2반,60,106,48,58,2025-07-31
2012,화순읍,세량리1반,49,101,51,50,2025-07-31
2012,화순읍,수만리1반,41,78,44,34,2025-07-31
2012,화순읍,수만리2반,24,41,24,17,2025-07-31
2012,화순읍,수만리3반,57,107,62,45,2025-07-31
2012,화순읍,신기리1반,369,813,440,373,2025-07-31
2012,화순읍,신기리2반,1329,3787,1863,1924,2025-07-31
2012,화순읍,신기리3반,247,629,314,315,2025-07-31
2012,화순읍,앵남리1반,51,102,54,48,2025-07-31
2012,화순읍,앵남리2반,54,88,45,43,2025-07-31
2012,화순읍,연양리1반,52,115,59,56,2025-07-31
2012,화순읍,연양리2반,89,182,98,84,2025-07-31
2012,화순읍,유천리1반,63,152,77,75,2025-07-31
2012,화순읍,유천리2반,45,108,53,55,2025-07-31
2012,화순읍,유천리3반,43,88,41,47,2025-07-31
2012,화순읍,이십곡리,74,146,76,70,2025-07-31
2012,화순읍,이십곡리,42,88,48,40,2025-07-31
2012,화순읍,일심리1반,206,499,255,244,2025-07-31
2012,화순읍,일심리2반,47,116,62,54,2025-07-31
2012,화순읍,일심리3반,45,108,56,52,2025-07-31
2012,화순읍,일심리4반,414,1160,536,624,2025-07-31
2012,화순읍,일심리5반,537,1427,708,719,2025-07-31
2012,화순읍,일심리6반,654,2097,1004,1093,2025-07-31
2012,화순읍,주도리1반,35,60,35,25,2025-07-31
2012,화순읍,주도리2반,64,119,57,62,2025-07-31
2012,화순읍,주도리3반,42,81,40,41,2025-07-31
2012,화순읍,향청리1반,275,614,319,295,2025-07-31
2012,화순읍,훈리1반,188,450,234,216,2025-07-31
2012,한천면,모산1,99,206,103,103,2025-07-31
2012,한천면,모산2,26,41,23,18,2025-07-31
2012,한천면,금전리,48,101,53,48,2025-07-31
2012,한천면,한계1,112,226,111,115,2025-07-31
2012,한천면,한계2,60,126,62,64,2025-07-31
2012,한천면,정리1,22,29,18,11,2025-07-31
2012,한천면,정리2,28,65,32,33,2025-07-31
2012,한천면,가암1,32,55,28,27,2025-07-31
2012,한천면,가암2,37,64,24,40,2025-07-31
2012,한천면,오음1,35,73,34,39,2025-07-31
2012,한천면,오음2,24,48,26,22,2025-07-31
2012,한천면,오음3,27,41,23,18,2025-07-31
2012,한천면,반곡1,33,63,31,32,2025-07-31
2012,한천면,반곡2,40,67,36,31,2025-07-31
2012,한천면,평리,46,97,49,48,2025-07-31
2012,한천면,정우리,44,86,38,48,2025-07-31
2012,한천면,동가1,69,132,67,65,2025-07-31
2012,한천면,동가2,35,69,33,36,2025-07-31
2012,한천면,고시리,6,11,7,4,2025-07-31
2012,춘양면,석정리,253,495,270,225,2025-07-31
2012,춘양면,화림리1,29,55,21,34,2025-07-31
2012,춘양면,화림리2,61,105,52,53,2025-07-31
2012,춘양면,화림리3,38,75,30,45,2025-07-31
2012,춘양면,대신리1,32,66,35,31,2025-07-31
2012,춘양면,대신리2,23,42,19,23,2025-07-31
2012,춘양면,대신리3,30,58,33,25,2025-07-31
2012,춘양면,회송리1,36,66,32,34,2025-07-31
2012,춘양면,회송리2,28,49,29,20,2025-07-31
2012,춘양면,양곡리1,49,110,59,51,2025-07-31
2012,춘양면,용곡리1,61,106,55,51,2025-07-31
2012,춘양면,월평리1,37,78,36,42,2025-07-31
2012,춘양면,월평리2,24,48,23,25,2025-07-31
2012,춘양면,월평리3,19,30,15,15,2025-07-31
2012,춘양면,변천리1,58,103,52,51,2025-07-31
2012,춘양면,가동리1,9,15,8,7,2025-07-31
2012,춘양면,산간리1,61,110,51,59,2025-07-31
2012,춘양면,가봉리1,76,148,71,77,2025-07-31
2012,춘양면,용두리1,41,72,30,42,2025-07-31
2012,춘양면,우봉리1,75,205,98,107,2025-07-31
2012,춘양면,부곡리1,25,46,19,27,2025-07-31
2012,춘양면,부곡리2,30,54,27,27,2025-07-31
2012,춘양면,부곡리3,26,54,32,22,2025-07-31
2012,청풍면,풍암리1,78,144,66,78,2025-07-31
2012,청풍면,한지리1,39,75,36,39,2025-07-31
2012,청풍면,한지리2,30,55,24,31,2025-07-31
2012,청풍면,어리1,48,85,44,41,2025-07-31
2012,청풍면,세청리1,65,118,57,61,2025-07-31
2012,청풍면,세청리2,18,24,10,14,2025-07-31
2012,청풍면,대비리1,48,86,42,44,2025-07-31
2012,청풍면,백운리1,35,69,30,39,2025-07-31
2012,청풍면,청용리1,34,59,30,29,2025-07-31
2012,청풍면,이만리1,18,24,13,11,2025-07-31
2012,청풍면,신석리1,21,35,17,18,2025-07-31
2012,청풍면,신석리2,25,44,24,20,2025-07-31
2012,청풍면,신리1,53,97,52,45,2025-07-31
2012,청풍면,신리2,38,72,40,32,2025-07-31
2012,청풍면,차리1,29,51,19,32,2025-07-31
2012,청풍면,차리2,100,207,92,115,2025-07-31
2012,이양면,금능1,88,203,92,111,2025-07-31
2012,이양면,강성리1,45,61,22,39,2025-07-31
2012,이양면,강성리2,28,53,29,24,2025-07-31
2012,이양면,강성리3,32,59,31,28,2025-07-31
2012,이양면,용반리1,31,49,22,27,2025-07-31
2012,이양면,장치리1,21,32,13,19,2025-07-31
2012,이양면,묵곡리1,26,41,20,21,2025-07-31
2012,이양면,묵곡리2,26,50,24,26,2025-07-31
2012,이양면,옥리1,15,35,15,20,2025-07-31
2012,이양면,품평리1,48,87,39,48,2025-07-31
2012,이양면,품평리2,36,103,51,52,2025-07-31
2012,이양면,품평리3,38,73,35,38,2025-07-31
2012,이양면,오류리1,100,195,96,99,2025-07-31
2012,이양면,오류리2,41,86,44,42,2025-07-31
2012,이양면,오류리3,45,92,46,46,2025-07-31
2012,이양면,오류리4,25,44,23,21,2025-07-31
2012,이양면,이양리1,58,96,38,58,2025-07-31
2012,이양면,이양리2,62,129,58,71,2025-07-31
2012,이양면,율계리1,44,80,40,40,2025-07-31
2012,이양면,송정리1,21,36,14,22,2025-07-31
2012,이양면,송정리2,27,45,27,18,2025-07-31
2012,이양면,초방리1,30,59,28,31,2025-07-31
2012,이양면,초방리2,26,43,19,24,2025-07-31
2012,이양면,매정리1,22,47,26,21,2025-07-31
2012,이양면,매정리2,32,66,30,36,2025-07-31
2012,이양면,연화리1,27,46,28,18,2025-07-31
2012,이양면,구례리1,34,62,30,32,2025-07-31
2012,이양면,쌍봉리1,76,143,65,78,2025-07-31
2012,이양면,증리1,23,37,18,19,2025-07-31
2012,능주면,남정리1,138,291,154,137,2025-07-31
2012,능주면,남정리2,32,53,21,32,2025-07-31
2012,능주면,정남리1,80,174,78,96,2025-07-31
2012,능주면,석고리1,195,418,213,205,2025-07-31
2012,능주면,잠정리1,217,528,264,264,2025-07-31
2012,능주면,내리1,30,65,39,26,2025-07-31
2012,능주면,관영리1,274,621,298,323,2025-07-31
2012,능주면,천덕리1,71,140,71,69,2025-07-31
2012,능주면,천덕리2,47,96,42,54,2025-07-31
2012,능주면,만인리1,66,153,82,71,2025-07-31
2012,능주면,광사리1,42,92,49,43,2025-07-31
2012,능주면,백암리1,99,182,93,89,2025-07-31
2012,능주면,백암리2,49,99,49,50,2025-07-31
2012,능주면,만수리1,66,159,83,76,2025-07-31
2012,능주면,만수리2,50,122,58,64,2025-07-31
2012,능주면,원지리1,98,201,91,110,2025-07-31
2012,도곡면,대곡리1반,38,77,39,38,2025-07-31
2012,도곡면,대곡리2반,57,111,57,54,2025-07-31
2012,도곡면,대곡리3반,61,112,58,54,2025-07-31
2012,도곡면,효산리1반,149,307,157,150,2025-07-31
2012,도곡면,효산리2반,70,140,69,71,2025-07-31
2012,도곡면,월곡리1반,41,76,35,41,2025-07-31
2012,도곡면,월곡리2반,47,93,41,52,2025-07-31
2012,도곡면,월곡리3반,38,73,42,31,2025-07-31
2012,도곡면,쌍옥리1반,81,169,75,94,2025-07-31
2012,도곡면,쌍옥리2반,57,96,51,45,2025-07-31
2012,도곡면,평리1반,82,168,84,84,2025-07-31
2012,도곡면,덕곡리1반,36,57,23,34,2025-07-31
2012,도곡면,덕곡리2반,33,78,45,33,2025-07-31
2012,도곡면,신성리1반,52,97,48,49,2025-07-31
2012,도곡면,신성리2반,54,111,49,62,2025-07-31
2012,도곡면,천암리1반,222,504,250,254,2025-07-31
2012,도곡면,원화리1반,83,160,83,77,2025-07-31
2012,도곡면,원화리2반,46,78,36,42,2025-07-31
2012,도곡면,신덕리1반,59,113,58,55,2025-07-31
2012,도곡면,신덕리2반,40,65,24,41,2025-07-31
2012,도곡면,신덕리3반,32,68,32,36,2025-07-31
2012,도곡면,미곡리1반,34,64,32,32,2025-07-31
2012,도곡면,미곡리2반,52,100,49,51,2025-07-31
2012,도곡면,족청리1반,75,181,99,82,2025-07-31
2012,도곡면,족청리2반,26,47,24,23,2025-07-31
2012,도암면,운월리1,31,60,31,29,2025-07-31
2012,도암면,운월리2,36,55,29,26,2025-07-31
2012,도암면,도장리1,62,148,69,79,2025-07-31
2012,도암면,벽지리1,34,55,23,32,2025-07-31
2012,도암면,벽지리1,22,55,31,24,2025-07-31
2012,도암면,정천리1,80,143,80,63,2025-07-31
2012,도암면,원천리1,52,99,51,48,2025-07-31
2012,도암면,원천리2,23,49,29,20,2025-07-31
2012,도암면,원천리3,67,115,57,58,2025-07-31
2012,도암면,천태리1,37,77,40,37,2025-07-31
2012,도암면,천태리2,38,74,34,40,2025-07-31
2012,도암면,지월리1,17,46,26,20,2025-07-31
2012,도암면,지월리2,52,95,48,47,2025-07-31
2012,도암면,등광리1,54,95,53,42,2025-07-31
2012,도암면,대초리1,29,58,30,28,2025-07-31
2012,도암면,용강리1,47,71,36,35,2025-07-31
2012,도암면,용강리2,31,50,26,24,2025-07-31
2012,도암면,용강리3,48,100,53,47,2025-07-31
2012,도암면,호암리1,23,42,22,20,2025-07-31
2012,도암면,호암리2,21,40,20,20,2025-07-31
2012,도암면,우치리1,24,38,16,22,2025-07-31
2012,도암면,봉하리1,21,37,19,18,2025-07-31
2012,도암면,왕정리1,6,12,6,6,2025-07-31
2012,도암면,행산리1,9,24,10,14,2025-07-31
2012,이서면,"서리,월산리1",16,29,18,11,2025-07-31
2012,이서면,창랑리1,33,45,21,24,2025-07-31
2012,이서면,야사리1,65,131,64,67,2025-07-31
2012,이서면,야사리2,55,97,48,49,2025-07-31
2012,이서면,야사리3,22,49,21,28,2025-07-31
2012,이서면,야사리4,26,39,18,21,2025-07-31
2012,이서면,보월리1,70,138,65,73,2025-07-31
2012,이서면,보월리2,23,33,16,17,2025-07-31
2012,이서면,인계리1,43,75,32,43,2025-07-31
2012,이서면,인계리2,30,56,31,25,2025-07-31
2012,이서면,영평리1,88,161,80,81,2025-07-31
2012,이서면,안심리1,62,112,60,52,2025-07-31
2012,이서면,안심리2,23,42,25,17,2025-07-31
2012,이서면,갈두리1,7,11,8,3,2025-07-31
2012,백아면,임곡리1,61,118,58,60,2025-07-31
2012,백아면,옥리1구1,52,115,52,63,2025-07-31
2012,백아면,옥리2구2,30,48,25,23,2025-07-31
2012,백아면,서유리1구1,62,120,60,60,2025-07-31
2012,백아면,서유리2구2,24,47,24,23,2025-07-31
2012,백아면,맹리1,38,62,36,26,2025-07-31
2012,백아면,남치리1,51,108,50,58,2025-07-31
2012,백아면,원리1,114,224,107,117,2025-07-31
2012,백아면,송단리1구1,33,59,28,31,2025-07-31
2012,백아면,송단리2구2,39,70,37,33,2025-07-31
2012,백아면,방리1,29,58,29,29,2025-07-31
2012,백아면,노기리1,32,70,32,38,2025-07-31
2012,백아면,이천리1구1,49,96,44,52,2025-07-31
2012,백아면,이천리2구2,71,125,65,60,2025-07-31
2012,백아면,길성리1,54,82,37,45,2025-07-31
2012,백아면,와천리1,20,39,18,21,2025-07-31
2012,백아면,다곡리1,71,117,54,63,2025-07-31
2012,백아면,수리1,88,166,76,90,2025-07-31
2012,백아면,노치리1,19,54,30,24,2025-07-31
2012,백아면,용곡리1구1,38,62,30,32,2025-07-31
2012,백아면,용곡리2구2,19,28,14,14,2025-07-31
2012,동복면,독상리1,129,242,117,125,2025-07-31
2012,동복면,칠정리1,62,114,55,59,2025-07-31
2012,동복면,칠정리2,30,58,24,34,2025-07-31
2012,동복면,천변리1,98,224,112,112,2025-07-31
2012,동복면,유천리1,76,136,69,67,2025-07-31
2012,동복면,신율리1,37,80,42,38,2025-07-31
2012,동복면,신율리2,20,43,22,21,2025-07-31
2012,동복면,신율리3,25,47,18,29,2025-07-31
2012,동복면,가수리1,38,86,40,46,2025-07-31
2012,동복면,가수리2,18,41,16,25,2025-07-31
2012,동복면,가수리3,21,37,15,22,2025-07-31
2012,동복면,안성리1,62,117,60,57,2025-07-31
2012,동복면,연월리1,46,79,31,48,2025-07-31
2012,동복면,연월리2,30,50,22,28,2025-07-31
2012,동복면,연월리3,32,60,33,27,2025-07-31
2012,동복면,읍애리1,38,65,33,32,2025-07-31
2012,동복면,연둔리1,39,61,26,35,2025-07-31
2012,동복면,연둔리2,22,32,12,20,2025-07-31
2012,동복면,구암리1,32,66,28,38,2025-07-31
2012,동복면,구암리2,30,57,27,30,2025-07-31
2012,동복면,한천리1,108,193,87,106,2025-07-31
2012,사평면,사평리1,56,107,56,51,2025-07-31
2012,사평면,사평리2,75,161,80,81,2025-07-31
2012,사평면,사평리3,54,133,68,65,2025-07-31
2012,사평면,사평리4,65,143,72,71,2025-07-31
2012,사평면,사평리5,82,143,67,76,2025-07-31
2012,사평면,대곡리1,42,82,39,43,2025-07-31
2012,사평면,대곡리2,19,34,18,16,2025-07-31
2012,사평면,검산리1,43,86,48,38,2025-07-31
2012,사평면,검산리2,21,43,20,23,2025-07-31
2012,사평면,운산리1,34,56,29,27,2025-07-31
2012,사평면,원리1,50,98,44,54,2025-07-31
2012,사평면,원리2,32,52,25,27,2025-07-31
2012,사평면,벽송리1,105,222,110,112,2025-07-31
2012,사평면,벽송리2,27,49,25,24,2025-07-31
2012,사평면,장전리1,53,114,55,59,2025-07-31
2012,사평면,장전리2,31,74,38,36,2025-07-31
2012,사평면,절산리1,71,135,60,75,2025-07-31
2012,사평면,절산리2,40,57,29,28,2025-07-31
2012,사평면,사수리1,28,67,36,31,2025-07-31
2012,사평면,사수리2,27,42,21,21,2025-07-31
2012,사평면,주산리1,26,55,30,25,2025-07-31
2012,사평면,복교리1,8,13,6,7,2025-07-31
2012,사평면,남계리1,55,92,42,50,2025-07-31
2012,사평면,유마리1,21,39,17,22,2025-07-31
2012,사평면,다산리1,49,89,44,45,2025-07-31
2012,사평면,용리1,23,41,20,21,2025-07-31
2012,사평면,용리2,42,78,41,37,2025-07-31
2012,사평면,내리1,33,59,23,36,2025-07-31
2012,사평면,내리2,26,48,24,24,2025-07-31
2012,사평면,내리3,35,72,44,28,2025-07-31
2012,동면,백용리1,40,103,51,52,2025-07-31
2012,동면,백용리2,74,174,86,88,2025-07-31
2012,동면,언도리1,60,106,49,57,2025-07-31
2012,동면,언도리2,47,111,49,62,2025-07-31
2012,동면,서성리1,31,56,30,26,2025-07-31
2012,동면,서성리2,32,64,38,26,2025-07-31
2012,동면,국동리1,38,59,32,27,2025-07-31
2012,동면,청궁리2,65,113,56,57,2025-07-31
2012,동면,마산리1,43,91,46,45,2025-07-31
2012,동면,무포리1,34,61,31,30,2025-07-31
2012,동면,무포리2,23,43,24,19,2025-07-31
2012,동면,경치리1,48,86,35,51,2025-07-31
2012,동면,경치리2,14,29,11,18,2025-07-31
2012,동면,복암리1,63,105,44,61,2025-07-31
2012,동면,복암리2,144,253,143,110,2025-07-31
2012,동면,복암리3,52,84,39,45,2025-07-31
2012,동면,오동리1,138,315,156,159,2025-07-31
2012,동면,오동리2,34,64,38,26,2025-07-31
2012,동면,오동리3,52,111,57,54,2025-07-31
2012,동면,천덕리1,49,96,57,39,2025-07-31
2012,동면,천덕리2,46,104,58,46,2025-07-31
2012,동면,천덕리3,69,149,73,76,2025-07-31
2012,동면,장동리1,153,293,148,145,2025-07-31
2012,동면,장동리2,92,202,89,113,2025-07-31
2012,동면,운농리1,83,164,92,72,2025-07-31
2012,동면,운농리2,79,162,100,62,2025-07-31
2012,동면,운농리3,68,141,75,66,2025-07-31
2012,동면,옥호리1,39,69,36,33,2025-07-31
2012,동면,옥호리2,35,51,27,24,2025-07-31
2012,동면,옥호리3,13,23,11,12,2025-07-31
2012,동면,대포리1,68,129,69,60,2025-07-31
2012,동면,대포리2,38,86,42,44,2025-07-31
2012,동면,대포리3,69,136,68,68,2025-07-31
2013,화순읍,감도리1반,65,135,74,61,2025-07-31
2013,화순읍,감도리2반,38,101,52,49,2025-07-31
2013,화순읍,감도리3반,19,50,22,28,2025-07-31
2013,화순읍,강정리1반,6,17,10,7,2025-07-31
2013,화순읍,계소리1반,168,446,219,227,2025-07-31
2013,화순읍,계소리2반,22,37,20,17,2025-07-31
2013,화순읍,계소리3반,50,120,69,51,2025-07-31
2013,화순읍,계소리4반,266,612,305,307,2025-07-31
2013,화순읍,광덕리1반,262,601,299,302,2025-07-31
2013,화순읍,광덕리2반,179,432,219,213,2025-07-31
2013,화순읍,광덕리3반,68,175,92,83,2025-07-31
2013,화순읍,광덕리4반,548,1671,807,864,2025-07-31
2013,화순읍,광덕리5반,462,1477,716,761,2025-07-31
2013,화순읍,교리1반,306,677,351,326,2025-07-31
2013,화순읍,교리2반,540,1697,837,860,2025-07-31
2013,화순읍,교리3반,175,416,206,210,2025-07-31
2013,화순읍,내평리1반,113,237,122,115,2025-07-31
2013,화순읍,다지리1반,82,233,118,115,2025-07-31
2013,화순읍,다지리2반,89,171,91,80,2025-07-31
2013,화순읍,대리1반,377,972,484,488,2025-07-31
2013,화순읍,대리2반,49,113,53,60,2025-07-31
2013,화순읍,대리3반,54,143,76,67,2025-07-31
2013,화순읍,대리4반,432,1350,640,710,2025-07-31
2013,화순읍,대리5반,420,1101,532,569,2025-07-31
2013,화순읍,대리6반,380,1259,616,643,2025-07-31
2013,화순읍,대리7반,405,820,392,428,2025-07-31
2013,화순읍,도웅리1반,76,148,74,74,2025-07-31
2013,화순읍,도웅리2반,22,32,13,19,2025-07-31
2013,화순읍,동구리1반,33,69,39,30,2025-07-31
2013,화순읍,만연리1반,110,265,141,124,2025-07-31
2013,화순읍,만연리2반,132,300,153,147,2025-07-31
2013,화순읍,만연리3반,924,2460,1160,1300,2025-07-31
2013,화순읍,만연리4반,518,1604,764,840,2025-07-31
2013,화순읍,만연리5반,1065,2713,1263,1450,2025-07-31
2013,화순읍,만연리6반,894,2422,1138,1284,2025-07-31
2013,화순읍,벽라리1반,103,236,117,119,2025-07-31
2013,화순읍,벽라리2반,140,283,138,145,2025-07-31
2013,화순읍,벽라리3반,393,1141,566,575,2025-07-31
2013,화순읍,삼천리1반,117,240,117,123,2025-07-31
2013,화순읍,삼천리2반,78,205,113,92,2025-07-31
2013,화순읍,삼천리3반,31,64,32,32,2025-07-31
2013,화순읍,삼천리4반,441,745,402,343,2025-07-31
2013,화순읍,서태리1반,89,184,100,84,2025-07-31
2013,화순읍,서태리2반,60,105,50,55,2025-07-31
2013,화순읍,세량리1반,50,100,54,46,2025-07-31
2013,화순읍,수만리1반,38,70,41,29,2025-07-31
2013,화순읍,수만리2반,20,35,20,15,2025-07-31
2013,화순읍,수만리3반,64,123,64,59,2025-07-31
2013,화순읍,신기리1반,372,828,444,384,2025-07-31
2013,화순읍,신기리2반,1332,3773,1858,1915,2025-07-31
2013,화순읍,신기리3반,267,670,348,322,2025-07-31
2013,화순읍,앵남리1반,43,91,47,44,2025-07-31
2013,화순읍,앵남리2반,51,87,45,42,2025-07-31
2013,화순읍,연양리1반,56,117,60,57,2025-07-31
2013,화순읍,연양리2반,88,177,91,86,2025-07-31
2013,화순읍,유천리1반,64,166,85,81,2025-07-31
2013,화순읍,유천리2반,44,97,48,49,2025-07-31
2013,화순읍,유천리3반,40,82,37,45,2025-07-31
2013,화순읍,이십곡리,72,151,80,71,2025-07-31
2013,화순읍,이십곡리,32,79,42,37,2025-07-31
2013,화순읍,일심리1반,220,513,259,254,2025-07-31
2013,화순읍,일심리2반,45,95,52,43,2025-07-31
2013,화순읍,일심리3반,42,105,62,43,2025-07-31
2013,화순읍,일심리4반,423,1144,525,619,2025-07-31
2013,화순읍,일심리5반,556,1403,704,699,2025-07-31
2013,화순읍,일심리6반,657,2109,1010,1099,2025-07-31
2013,화순읍,주도리1반,39,73,41,32,2025-07-31
2013,화순읍,주도리2반,61,111,52,59,2025-07-31
2013,화순읍,주도리3반,45,98,53,45,2025-07-31
2013,화순읍,향청리1반,272,582,307,275,2025-07-31
2013,화순읍,훈리1반,187,447,228,219,2025-07-31
2013,한천면,모산1,95,190,97,93,2025-07-31
2013,한천면,모산2,23,35,20,15,2025-07-31
2013,한천면,금전리,45,93,48,45,2025-07-31
2013,한천면,한계1,110,222,108,114,2025-07-31
2013,한천면,한계2,60,117,53,64,2025-07-31
2013,한천면,정리1,22,35,21,14,2025-07-31
2013,한천면,정리2,29,69,34,35,2025-07-31
2013,한천면,가암1,30,59,28,31,2025-07-31
2013,한천면,가암2,36,59,22,37,2025-07-31
2013,한천면,오음1,35,67,31,36,2025-07-31
2013,한천면,오음2,24,55,31,24,2025-07-31
2013,한천면,오음3,25,37,22,15,2025-07-31
2013,한천면,반곡1,31,59,29,30,2025-07-31
2013,한천면,반곡2,39,65,34,31,2025-07-31
2013,한천면,평리,51,103,50,53,2025-07-31
2013,한천면,정우리,45,79,34,45,2025-07-31
2013,한천면,동가1,68,123,62,61,2025-07-31
2013,한천면,동가2,34,70,36,34,2025-07-31
2013,한천면,고시리,5,10,6,4,2025-07-31
2013,춘양면,석정리,245,494,269,225,2025-07-31
2013,춘양면,화림리1,26,54,21,33,2025-07-31
2013,춘양면,화림리2,58,103,51,52,2025-07-31
2013,춘양면,화림리3,34,70,30,40,2025-07-31
2013,춘양면,대신리1,31,63,35,28,2025-07-31
2013,춘양면,대신리2,23,44,20,24,2025-07-31
2013,춘양면,대신리3,35,58,33,25,2025-07-31
2013,춘양면,회송리1,34,64,32,32,2025-07-31
2013,춘양면,회송리2,26,48,28,20,2025-07-31
2013,춘양면,양곡리1,46,102,56,46,2025-07-31
2013,춘양면,용곡리1,55,99,54,45,2025-07-31
2013,춘양면,월평리1,37,73,32,41,2025-07-31
2013,춘양면,월평리2,22,46,21,25,2025-07-31
2013,춘양면,월평리3,19,29,15,14,2025-07-31
2013,춘양면,변천리1,57,96,49,47,2025-07-31
2013,춘양면,가동리1,10,16,7,9,2025-07-31
2013,춘양면,산간리1,64,106,49,57,2025-07-31
2013,춘양면,가봉리1,73,136,62,74,2025-07-31
2013,춘양면,용두리1,41,76,32,44,2025-07-31
2013,춘양면,우봉리1,76,195,98,97,2025-07-31
2013,춘양면,부곡리1,26,50,23,27,2025-07-31
2013,춘양면,부곡리2,32,51,24,27,2025-07-31
2013,춘양면,부곡리3,25,49,28,21,2025-07-31
2013,청풍면,풍암리1,76,138,60,78,2025-07-31
2013,청풍면,한지리1,38,71,33,38,2025-07-31
2013,청풍면,한지리2,31,60,26,34,2025-07-31
2013,청풍면,어리1,45,75,37,38,2025-07-31
2013,청풍면,세청리1,63,121,56,65,2025-07-31
2013,청풍면,세청리2,18,23,9,14,2025-07-31
2013,청풍면,대비리1,50,84,41,43,2025-07-31
2013,청풍면,백운리1,38,74,32,42,2025-07-31
2013,청풍면,청용리1,35,58,28,30,2025-07-31
2013,청풍면,이만리1,20,25,14,11,2025-07-31
2013,청풍면,신석리1,21,32,16,16,2025-07-31
2013,청풍면,신석리2,22,43,22,21,2025-07-31
2013,청풍면,신리1,50,88,47,41,2025-07-31
2013,청풍면,신리2,38,72,38,34,2025-07-31
2013,청풍면,차리1,30,50,19,31,2025-07-31
2013,청풍면,차리2,104,209,94,115,2025-07-31
2013,이양면,금능1,88,189,88,101,2025-07-31
2013,이양면,강성리1,44,63,24,39,2025-07-31
2013,이양면,강성리2,30,51,29,22,2025-07-31
2013,이양면,강성리3,32,57,30,27,2025-07-31
2013,이양면,용반리1,33,49,21,28,2025-07-31
2013,이양면,장치리1,20,27,15,12,2025-07-31
2013,이양면,묵곡리1,29,45,22,23,2025-07-31
2013,이양면,묵곡리2,26,46,23,23,2025-07-31
2013,이양면,옥리1,16,35,17,18,2025-07-31
2013,이양면,품평리1,49,84,36,48,2025-07-31
2013,이양면,품평리2,34,91,44,47,2025-07-31
2013,이양면,품평리3,39,79,39,40,2025-07-31
2013,이양면,오류리1,100,200,101,99,2025-07-31
2013,이양면,오류리2,38,75,36,39,2025-07-31
2013,이양면,오류리3,45,96,46,50,2025-07-31
2013,이양면,오류리4,24,44,22,22,2025-07-31
2013,이양면,이양리1,54,93,39,54,2025-07-31
2013,이양면,이양리2,60,118,51,67,2025-07-31
2013,이양면,율계리1,46,76,38,38,2025-07-31
2013,이양면,송정리1,21,37,15,22,2025-07-31
2013,이양면,송정리2,26,47,29,18,2025-07-31
2013,이양면,초방리1,30,52,23,29,2025-07-31
2013,이양면,초방리2,25,43,19,24,2025-07-31
2013,이양면,매정리1,22,41,23,18,2025-07-31
2013,이양면,매정리2,34,64,31,33,2025-07-31
2013,이양면,연화리1,27,42,25,17,2025-07-31
2013,이양면,구례리1,34,63,30,33,2025-07-31
2013,이양면,쌍봉리1,72,134,60,74,2025-07-31
2013,이양면,증리1,25,38,19,19,2025-07-31
2013,능주면,남정리1,136,283,151,132,2025-07-31
2013,능주면,남정리2,34,58,22,36,2025-07-31
2013,능주면,정남리1,84,174,82,92,2025-07-31
2013,능주면,석고리1,194,398,200,198,2025-07-31
2013,능주면,잠정리1,166,406,183,223,2025-07-31
2013,능주면,잠정리2,192,520,270,250,2025-07-31
2013,능주면,내리1,28,62,37,25,2025-07-31
2013,능주면,관영리1,274,612,287,325,2025-07-31
2013,능주면,천덕리1,66,129,67,62,2025-07-31
2013,능주면,천덕리2,45,93,42,51,2025-07-31
2013,능주면,만인리1,69,150,80,70,2025-07-31
2013,능주면,광사리1,42,87,47,40,2025-07-31
2013,능주면,백암리1,100,174,89,85,2025-07-31
2013,능주면,백암리2,47,90,45,45,2025-07-31
2013,능주면,만수리1,66,151,77,74,2025-07-31
2013,능주면,만수리2,46,107,50,57,2025-07-31
2013,능주면,원지리1,98,188,84,104,2025-07-31
2013,도곡면,대곡리1반,42,88,44,44,2025-07-31
2013,도곡면,대곡리2반,53,107,55,52,2025-07-31
2013,도곡면,대곡리3반,60,109,53,56,2025-07-31
2013,도곡면,효산리1반,154,306,160,146,2025-07-31
2013,도곡면,효산리2반,78,155,75,80,2025-07-31
2013,도곡면,월곡리1반,35,71,33,38,2025-07-31
2013,도곡면,월곡리2반,47,95,38,57,2025-07-31
2013,도곡면,월곡리3반,35,68,33,35,2025-07-31
2013,도곡면,쌍옥리1반,80,161,72,89,2025-07-31
2013,도곡면,쌍옥리2반,59,98,50,48,2025-07-31
2013,도곡면,평리1반,79,160,79,81,2025-07-31
2013,도곡면,덕곡리1반,37,57,23,34,2025-07-31
2013,도곡면,덕곡리2반,32,78,45,33,2025-07-31
2013,도곡면,신성리1반,47,88,46,42,2025-07-31
2013,도곡면,신성리2반,47,97,43,54,2025-07-31
2013,도곡면,천암리1반,229,507,251,256,2025-07-31
2013,도곡면,원화리1반,71,148,77,71,2025-07-31
2013,도곡면,원화리2반,51,81,39,42,2025-07-31
2013,도곡면,신덕리1반,59,115,56,59,2025-07-31
2013,도곡면,신덕리2반,41,68,27,41,2025-07-31
2013,도곡면,신덕리3반,33,68,29,39,2025-07-31
2013,도곡면,미곡리1반,33,68,34,34,2025-07-31
2013,도곡면,미곡리2반,52,99,51,48,2025-07-31
2013,도곡면,족청리1반,76,172,93,79,2025-07-31
2013,도곡면,족청리2반,26,45,24,21,2025-07-31
2013,도암면,운월리1,32,58,29,29,2025-07-31
2013,도암면,운월리2,34,56,28,28,2025-07-31
2013,도암면,도장리1,60,145,70,75,2025-07-31
2013,도암면,벽지리1,33,55,22,33,2025-07-31
2013,도암면,벽지리1,21,56,29,27,2025-07-31
2013,도암면,정천리1,78,143,78,65,2025-07-31
2013,도암면,원천리1,48,84,43,41,2025-07-31
2013,도암면,원천리2,22,49,28,21,2025-07-31
2013,도암면,원천리3,64,114,54,60,2025-07-31
2013,도암면,천태리1,39,79,40,39,2025-07-31
2013,도암면,천태리2,40,73,35,38,2025-07-31
2013,도암면,지월리1,19,44,27,17,2025-07-31
2013,도암면,지월리2,53,92,43,49,2025-07-31
2013,도암면,등광리1,51,88,48,40,2025-07-31
2013,도암면,대초리1,30,57,30,27,2025-07-31
2013,도암면,용강리1,46,72,37,35,2025-07-31
2013,도암면,용강리2,31,50,27,23,2025-07-31
2013,도암면,용강리3,45,94,49,45,2025-07-31
2013,도암면,호암리1,22,41,22,19,2025-07-31
2013,도암면,호암리2,21,36,18,18,2025-07-31
2013,도암면,우치리1,26,41,21,20,2025-07-31
2013,도암면,봉하리1,22,40,21,19,2025-07-31
2013,도암면,왕정리1,5,10,5,5,2025-07-31
2013,도암면,행산리1,9,22,10,12,2025-07-31
2013,이서면,"서리,월산리1",17,31,18,13,2025-07-31
2013,이서면,창랑리1,31,44,21,23,2025-07-31
2013,이서면,야사리1,67,132,66,66,2025-07-31
2013,이서면,야사리2,58,110,55,55,2025-07-31
2013,이서면,야사리3,20,50,23,27,2025-07-31
2013,이서면,야사리4,24,35,14,21,2025-07-31
2013,이서면,보월리1,68,133,63,70,2025-07-31
2013,이서면,보월리2,23,31,14,17,2025-07-31
2013,이서면,인계리1,47,81,34,47,2025-07-31
2013,이서면,인계리2,26,51,26,25,2025-07-31
2013,이서면,영평리1,65,131,64,67,2025-07-31
2013,이서면,영평리2,24,34,22,12,2025-07-31
2013,이서면,안심리1,64,115,66,49,2025-07-31
2013,이서면,안심리2,18,38,23,15,2025-07-31
2013,이서면,갈두리1,9,15,11,4,2025-07-31
2013,백아면,임곡리1,63,129,64,65,2025-07-31
2013,백아면,옥리1구1,50,109,50,59,2025-07-31
2013,백아면,옥리2구2,31,49,27,22,2025-07-31
2013,백아면,서유리1구1,62,119,60,59,2025-07-31
2013,백아면,서유리2구2,23,41,20,21,2025-07-31
2013,백아면,맹리1,38,54,31,23,2025-07-31
2013,백아면,남치리1,47,100,46,54,2025-07-31
2013,백아면,원리1,111,219,105,114,2025-07-31
2013,백아면,송단리1구1,31,54,26,28,2025-07-31
2013,백아면,송단리2구2,40,70,36,34,2025-07-31
2013,백아면,방리1,32,60,30,30,2025-07-31
2013,백아면,노기리1,35,71,33,38,2025-07-31
2013,백아면,이천리1구1,50,105,51,54,2025-07-31
2013,백아면,이천리2구2,80,140,71,69,2025-07-31
2013,백아면,길성리1,53,82,38,44,2025-07-31
2013,백아면,와천리1,20,38,18,20,2025-07-31
2013,백아면,다곡리1,68,114,54,60,2025-07-31
2013,백아면,수리1,88,157,71,86,2025-07-31
2013,백아면,노치리1,19,51,27,24,2025-07-31
2013,백아면,용곡리1구1,38,57,27,30,2025-07-31
2013,백아면,용곡리2구2,19,28,14,14,2025-07-31
2013,동복면,독상리1,127,240,115,125,2025-07-31
2013,동복면,칠정리1,52,100,48,52,2025-07-31
2013,동복면,칠정리2,32,56,23,33,2025-07-31
2013,동복면,천변리1,101,220,109,111,2025-07-31
2013,동복면,유천리1,76,131,67,64,2025-07-31
2013,동복면,신율리1,35,77,41,36,2025-07-31
2013,동복면,신율리2,20,43,23,20,2025-07-31
2013,동복면,신율리3,28,50,21,29,2025-07-31
2013,동복면,가수리1,37,85,41,44,2025-07-31
2013,동복면,가수리2,18,39,14,25,2025-07-31
2013,동복면,가수리3,18,32,16,16,2025-07-31
2013,동복면,안성리1,59,108,55,53,2025-07-31
2013,동복면,연월리1,48,79,30,49,2025-07-31
2013,동복면,연월리2,29,49,22,27,2025-07-31
2013,동복면,연월리3,32,55,30,25,2025-07-31
2013,동복면,읍애리1,40,69,35,34,2025-07-31
2013,동복면,연둔리1,40,61,26,35,2025-07-31
2013,동복면,연둔리2,20,31,12,19,2025-07-31
2013,동복면,구암리1,32,67,29,38,2025-07-31
2013,동복면,구암리2,31,57,27,30,2025-07-31
2013,동복면,한천리1,105,196,87,109,2025-07-31
2013,사평면,사평리1,55,107,56,51,2025-07-31
2013,사평면,사평리2,71,150,76,74,2025-07-31
2013,사평면,사평리3,55,126,70,56,2025-07-31
2013,사평면,사평리4,68,152,75,77,2025-07-31
2013,사평면,사평리5,85,153,72,81,2025-07-31
2013,사평면,대곡리1,43,84,44,40,2025-07-31
2013,사평면,대곡리2,20,32,17,15,2025-07-31
2013,사평면,검산리1,42,80,45,35,2025-07-31
2013,사평면,검산리2,21,42,19,23,2025-07-31
2013,사평면,운산리1,32,52,27,25,2025-07-31
2013,사평면,원리1,49,96,43,53,2025-07-31
2013,사평면,원리2,35,59,29,30,2025-07-31
2013,사평면,벽송리1,102,215,107,108,2025-07-31
2013,사평면,벽송리2,28,47,25,22,2025-07-31
2013,사평면,장전리1,53,114,54,60,2025-07-31
2013,사평면,장전리2,31,71,37,34,2025-07-31
2013,사평면,절산리1,72,124,57,67,2025-07-31
2013,사평면,절산리2,39,63,31,32,2025-07-31
2013,사평면,사수리1,27,55,30,25,2025-07-31
2013,사평면,사수리2,30,41,19,22,2025-07-31
2013,사평면,주산리1,25,53,29,24,2025-07-31
2013,사평면,복교리1,10,23,10,13,2025-07-31
2013,사평면,남계리1,54,80,37,43,2025-07-31
2013,사평면,유마리1,24,47,20,27,2025-07-31
2013,사평면,다산리1,52,94,48,46,2025-07-31
2013,사평면,용리1,21,33,14,19,2025-07-31
2013,사평면,용리2,41,74,38,36,2025-07-31
2013,사평면,내리1,32,58,23,35,2025-07-31
2013,사평면,내리2,26,43,22,21,2025-07-31
2013,사평면,내리3,35,75,45,30,2025-07-31
2013,동면,백용리1,39,92,44,48,2025-07-31
2013,동면,백용리2,76,167,83,84,2025-07-31
2013,동면,언도리1,58,100,47,53,2025-07-31
2013,동면,언도리2,46,108,45,63,2025-07-31
2013,동면,서성리1,31,49,25,24,2025-07-31
2013,동면,서성리2,31,60,36,24,2025-07-31
2013,동면,국동리1,38,60,33,27,2025-07-31
2013,동면,청궁리2,71,119,59,60,2025-07-31
2013,동면,마산리1,40,77,41,36,2025-07-31
2013,동면,무포리1,34,66,31,35,2025-07-31
2013,동면,무포리2,20,40,22,18,2025-07-31
2013,동면,경치리1,45,83,35,48,2025-07-31
2013,동면,경치리2,14,27,10,17,2025-07-31
2013,동면,복암리1,62,103,46,57,2025-07-31
2013,동면,복암리2,147,248,141,107,2025-07-31
2013,동면,복암리3,48,75,33,42,2025-07-31
2013,동면,오동리1,154,339,171,168,2025-07-31
2013,동면,오동리2,32,57,33,24,2025-07-31
2013,동면,오동리3,55,113,61,52,2025-07-31
2013,동면,천덕리1,48,97,57,40,2025-07-31
2013,동면,천덕리2,45,96,52,44,2025-07-31
2013,동면,천덕리3,72,159,82,77,2025-07-31
2013,동면,장동리1,149,279,139,140,2025-07-31
2013,동면,장동리2,87,192,85,107,2025-07-31
2013,동면,운농리1,83,156,85,71,2025-07-31
2013,동면,운농리2,73,137,81,56,2025-07-31
2013,동면,운농리3,64,127,67,60,2025-07-31
2013,동면,옥호리1,36,73,36,37,2025-07-31
2013,동면,옥호리2,34,50,27,23,2025-07-31
2013,동면,옥호리3,17,28,15,13,2025-07-31
2013,동면,대포리1,66,123,67,56,2025-07-31
2013,동면,대포리2,41,76,41,35,2025-07-31
2013,동면,대포리3,64,120,63,57,2025-07-31
2014,화순읍,감도리1반,63,135,72,63,2025-07-31
2014,화순읍,감도리2반,41,105,52,53,2025-07-31
2014,화순읍,감도리3반,19,50,22,28,2025-07-31
2014,화순읍,강정리1반,5,12,7,5,2025-07-31
2014,화순읍,계소리1반,167,440,221,219,2025-07-31
2014,화순읍,계소리2반,20,35,21,14,2025-07-31
2014,화순읍,계소리3반,51,122,70,52,2025-07-31
2014,화순읍,계소리4반,270,637,321,316,2025-07-31
2014,화순읍,광덕리1반,259,606,294,312,2025-07-31
2014,화순읍,광덕리2반,178,431,221,210,2025-07-31
2014,화순읍,광덕리3반,69,186,93,93,2025-07-31
2014,화순읍,광덕리4반,549,1650,795,855,2025-07-31
2014,화순읍,광덕리5반,453,1394,677,717,2025-07-31
2014,화순읍,교리1반,285,645,330,315,2025-07-31
2014,화순읍,교리2반,539,1661,828,833,2025-07-31
2014,화순읍,교리3반,175,397,202,195,2025-07-31
2014,화순읍,내평리1반,113,239,121,118,2025-07-31
2014,화순읍,다지리1반,89,237,113,124,2025-07-31
2014,화순읍,다지리2반,85,161,81,80,2025-07-31
2014,화순읍,대리1반,373,963,478,485,2025-07-31
2014,화순읍,대리2반,43,102,50,52,2025-07-31
2014,화순읍,대리3반,53,134,69,65,2025-07-31
2014,화순읍,대리4반,426,1340,638,702,2025-07-31
2014,화순읍,대리5반,387,980,461,519,2025-07-31
2014,화순읍,대리6반,377,1264,623,641,2025-07-31
2014,화순읍,대리7반,396,786,374,412,2025-07-31
2014,화순읍,도웅리1반,76,149,75,74,2025-07-31
2014,화순읍,도웅리2반,20,35,14,21,2025-07-31
2014,화순읍,동구리1반,31,58,33,25,2025-07-31
2014,화순읍,만연리1반,115,273,145,128,2025-07-31
2014,화순읍,만연리2반,126,302,160,142,2025-07-31
2014,화순읍,만연리3반,910,2363,1114,1249,2025-07-31
2014,화순읍,만연리4반,526,1600,761,839,2025-07-31
2014,화순읍,만연리5반,1066,2689,1237,1452,2025-07-31
2014,화순읍,만연리6반,913,2412,1131,1281,2025-07-31
2014,화순읍,벽라리1반,105,226,115,111,2025-07-31
2014,화순읍,벽라리2반,133,269,132,137,2025-07-31
2014,화순읍,벽라리3반,384,1110,543,567,2025-07-31
2014,화순읍,삼천리1반,114,234,115,119,2025-07-31
2014,화순읍,삼천리2반,78,199,110,89,2025-07-31
2014,화순읍,삼천리3반,33,64,30,34,2025-07-31
2014,화순읍,삼천리4반,447,762,411,351,2025-07-31
2014,화순읍,서태리1반,84,179,95,84,2025-07-31
2014,화순읍,서태리2반,58,98,48,50,2025-07-31
2014,화순읍,세량리1반,51,97,52,45,2025-07-31
2014,화순읍,수만리1반,33,53,30,23,2025-07-31
2014,화순읍,수만리2반,25,45,25,20,2025-07-31
2014,화순읍,수만리3반,56,103,53,50,2025-07-31
2014,화순읍,신기리1반,359,781,425,356,2025-07-31
2014,화순읍,신기리2반,1345,3835,1899,1936,2025-07-31
2014,화순읍,신기리3반,295,716,356,360,2025-07-31
2014,화순읍,앵남리1반,47,99,53,46,2025-07-31
2014,화순읍,앵남리2반,46,76,38,38,2025-07-31
2014,화순읍,연양리1반,52,115,58,57,2025-07-31
2014,화순읍,연양리2반,84,167,90,77,2025-07-31
2014,화순읍,유천리1반,57,158,82,76,2025-07-31
2014,화순읍,유천리2반,44,89,49,40,2025-07-31
2014,화순읍,유천리3반,37,75,34,41,2025-07-31
2014,화순읍,이십곡리,66,138,71,67,2025-07-31
2014,화순읍,이십곡리,35,76,41,35,2025-07-31
2014,화순읍,일심리1반,227,499,261,238,2025-07-31
2014,화순읍,일심리2반,47,103,53,50,2025-07-31
2014,화순읍,일심리3반,34,96,52,44,2025-07-31
2014,화순읍,일심리4반,413,1129,516,613,2025-07-31
2014,화순읍,일심리5반,565,1400,703,697,2025-07-31
2014,화순읍,일심리6반,649,2044,975,1069,2025-07-31
2014,화순읍,주도리1반,37,71,41,30,2025-07-31
2014,화순읍,주도리2반,56,102,46,56,2025-07-31
2014,화순읍,주도리3반,52,102,57,45,2025-07-31
2014,화순읍,향청리1반,270,574,306,268,2025-07-31
2014,화순읍,훈리1반,189,450,232,218,2025-07-31
2014,한천면,모산1,102,199,100,99,2025-07-31
2014,한천면,모산2,22,34,19,15,2025-07-31
2014,한천면,금전리,49,86,42,44,2025-07-31
2014,한천면,한계1,107,214,105,109,2025-07-31
2014,한천면,한계2,54,110,53,57,2025-07-31
2014,한천면,정리1,24,38,20,18,2025-07-31
2014,한천면,정리2,28,70,36,34,2025-07-31
2014,한천면,가암1,29,57,27,30,2025-07-31
2014,한천면,가암2,41,58,23,35,2025-07-31
2014,한천면,오음1,42,84,42,42,2025-07-31
2014,한천면,오음2,25,55,28,27,2025-07-31
2014,한천면,오음3,19,28,14,14,2025-07-31
2014,한천면,반곡1,32,64,33,31,2025-07-31
2014,한천면,반곡2,39,61,34,27,2025-07-31
2014,한천면,평리,52,101,48,53,2025-07-31
2014,한천면,정우리,45,82,35,47,2025-07-31
2014,한천면,동가1,67,119,60,59,2025-07-31
2014,한천면,동가2,31,64,34,30,2025-07-31
2014,한천면,고시리,5,13,8,5,2025-07-31
2014,춘양면,석정리,232,469,254,215,2025-07-31
2014,춘양면,화림리1,27,56,23,33,2025-07-31
2014,춘양면,화림리2,56,102,51,51,2025-07-31
2014,춘양면,화림리3,35,69,30,39,2025-07-31
2014,춘양면,대신리1,32,66,37,29,2025-07-31
2014,춘양면,대신리2,22,43,20,23,2025-07-31
2014,춘양면,대신리3,35,61,34,27,2025-07-31
2014,춘양면,회송리1,37,63,29,34,2025-07-31
2014,춘양면,회송리2,29,46,29,17,2025-07-31
2014,춘양면,양곡리1,49,97,52,45,2025-07-31
2014,춘양면,용곡리1,52,97,50,47,2025-07-31
2014,춘양면,월평리1,34,71,32,39,2025-07-31
2014,춘양면,월평리2,22,44,19,25,2025-07-31
2014,춘양면,월평리3,20,32,19,13,2025-07-31
2014,춘양면,변천리1,56,97,51,46,2025-07-31
2014,춘양면,가동리1,10,14,6,8,2025-07-31
2014,춘양면,산간리1,61,102,47,55,2025-07-31
2014,춘양면,가봉리1,75,141,65,76,2025-07-31
2014,춘양면,용두리1,42,76,34,42,2025-07-31
2014,춘양면,우봉리1,80,201,102,99,2025-07-31
2014,춘양면,부곡리1,27,50,21,29,2025-07-31
2014,춘양면,부곡리2,28,45,19,26,2025-07-31
2014,춘양면,부곡리3,24,48,26,22,2025-07-31
2014,청풍면,풍암리1,76,137,59,78,2025-07-31
2014,청풍면,한지리1,37,56,22,34,2025-07-31
2014,청풍면,한지리2,30,56,25,31,2025-07-31
2014,청풍면,어리1,44,74,35,39,2025-07-31
2014,청풍면,세청리1,61,111,52,59,2025-07-31
2014,청풍면,세청리2,17,23,10,13,2025-07-31
2014,청풍면,대비리1,46,73,37,36,2025-07-31
2014,청풍면,백운리1,38,76,34,42,2025-07-31
2014,청풍면,청용리1,37,60,27,33,2025-07-31
2014,청풍면,이만리1,19,25,13,12,2025-07-31
2014,청풍면,신석리1,21,31,16,15,2025-07-31
2014,청풍면,신석리2,24,45,24,21,2025-07-31
2014,청풍면,신리1,46,78,39,39,2025-07-31
2014,청풍면,신리2,38,70,36,34,2025-07-31
2014,청풍면,차리1,30,51,20,31,2025-07-31
2014,청풍면,차리2,96,190,93,97,2025-07-31
2014,이양면,금능1,84,187,83,104,2025-07-31
2014,이양면,강성리1,43,70,28,42,2025-07-31
2014,이양면,강성리2,31,51,26,25,2025-07-31
2014,이양면,강성리3,29,55,27,28,2025-07-31
2014,이양면,용반리1,29,42,16,26,2025-07-31
2014,이양면,장치리1,18,23,10,13,2025-07-31
2014,이양면,묵곡리1,27,44,21,23,2025-07-31
2014,이양면,묵곡리2,23,45,23,22,2025-07-31
2014,이양면,옥리1,17,34,16,18,2025-07-31
2014,이양면,품평리1,48,78,31,47,2025-07-31
2014,이양면,품평리2,35,92,44,48,2025-07-31
2014,이양면,품평리3,38,80,40,40,2025-07-31
2014,이양면,오류리1,94,181,92,89,2025-07-31
2014,이양면,오류리2,38,75,36,39,2025-07-31
2014,이양면,오류리3,42,89,44,45,2025-07-31
2014,이양면,오류리4,24,43,22,21,2025-07-31
2014,이양면,이양리1,55,91,39,52,2025-07-31
2014,이양면,이양리2,56,104,45,59,2025-07-31
2014,이양면,율계리1,46,75,37,38,2025-07-31
2014,이양면,송정리1,20,36,15,21,2025-07-31
2014,이양면,송정리2,26,47,28,19,2025-07-31
2014,이양면,초방리1,31,53,25,28,2025-07-31
2014,이양면,초방리2,25,44,18,26,2025-07-31
2014,이양면,매정리1,22,39,21,18,2025-07-31
2014,이양면,매정리2,32,64,32,32,2025-07-31
2014,이양면,연화리1,27,42,25,17,2025-07-31
2014,이양면,구례리1,32,59,28,31,2025-07-31
2014,이양면,쌍봉리1,73,123,55,68,2025-07-31
2014,이양면,증리1,29,45,24,21,2025-07-31
2014,능주면,남정리1,133,273,151,122,2025-07-31
2014,능주면,남정리2,33,55,21,34,2025-07-31
2014,능주면,정남리1,84,171,87,84,2025-07-31
2014,능주면,석고리1,186,368,186,182,2025-07-31
2014,능주면,잠정리1,169,379,166,213,2025-07-31
2014,능주면,잠정리2,243,653,329,324,2025-07-31
2014,능주면,내리1,27,59,33,26,2025-07-31
2014,능주면,관영리1,277,593,283,310,2025-07-31
2014,능주면,천덕리1,70,125,67,58,2025-07-31
2014,능주면,천덕리2,44,84,36,48,2025-07-31
2014,능주면,만인리1,69,152,84,68,2025-07-31
2014,능주면,광사리1,46,91,50,41,2025-07-31
2014,능주면,백암리1,99,179,91,88,2025-07-31
2014,능주면,백암리2,46,102,48,54,2025-07-31
2014,능주면,만수리1,62,142,71,71,2025-07-31
2014,능주면,만수리2,45,109,52,57,2025-07-31
2014,능주면,원지리1,96,179,82,97,2025-07-31
2014,도곡면,대곡리1반,40,88,44,44,2025-07-31
2014,도곡면,대곡리2반,58,107,60,47,2025-07-31
2014,도곡면,대곡리3반,65,117,56,61,2025-07-31
2014,도곡면,효산리1반,157,310,164,146,2025-07-31
2014,도곡면,효산리2반,77,146,68,78,2025-07-31
2014,도곡면,월곡리1반,41,85,39,46,2025-07-31
2014,도곡면,월곡리2반,48,92,40,52,2025-07-31
2014,도곡면,월곡리3반,38,67,32,35,2025-07-31
2014,도곡면,쌍옥리1반,76,162,73,89,2025-07-31
2014,도곡면,쌍옥리2반,58,99,49,50,2025-07-31
2014,도곡면,평리1반,80,151,70,81,2025-07-31
2014,도곡면,덕곡리1반,37,57,24,33,2025-07-31
2014,도곡면,덕곡리2반,31,74,39,35,2025-07-31
2014,도곡면,신성리1반,49,87,44,43,2025-07-31
2014,도곡면,신성리2반,46,92,43,49,2025-07-31
2014,도곡면,천암리1반,226,499,245,254,2025-07-31
2014,도곡면,원화리1반,71,137,70,67,2025-07-31
2014,도곡면,원화리2반,49,90,44,46,2025-07-31
2014,도곡면,신덕리1반,60,118,58,60,2025-07-31
2014,도곡면,신덕리2반,39,66,27,39,2025-07-31
2014,도곡면,신덕리3반,36,73,32,41,2025-07-31
2014,도곡면,미곡리1반,34,74,35,39,2025-07-31
2014,도곡면,미곡리2반,49,97,51,46,2025-07-31
2014,도곡면,족청리1반,81,180,97,83,2025-07-31
2014,도곡면,족청리2반,25,43,20,23,2025-07-31
2014,도암면,운월리1,36,62,30,32,2025-07-31
2014,도암면,운월리2,33,53,26,27,2025-07-31
2014,도암면,도장리1,58,135,67,68,2025-07-31
2014,도암면,벽지리1,34,57,24,33,2025-07-31
2014,도암면,벽지리1,21,54,30,24,2025-07-31
2014,도암면,정천리1,76,137,76,61,2025-07-31
2014,도암면,원천리1,49,83,43,40,2025-07-31
2014,도암면,원천리2,23,44,24,20,2025-07-31
2014,도암면,원천리3,64,118,57,61,2025-07-31
2014,도암면,천태리1,39,79,39,40,2025-07-31
2014,도암면,천태리2,44,80,39,41,2025-07-31
2014,도암면,지월리1,21,45,27,18,2025-07-31
2014,도암면,지월리2,56,93,44,49,2025-07-31
2014,도암면,등광리1,55,91,48,43,2025-07-31
2014,도암면,대초리1,35,57,30,27,2025-07-31
2014,도암면,용강리1,48,75,38,37,2025-07-31
2014,도암면,용강리2,30,48,25,23,2025-07-31
2014,도암면,용강리3,39,80,43,37,2025-07-31
2014,도암면,호암리1,22,39,21,18,2025-07-31
2014,도암면,호암리2,20,34,17,17,2025-07-31
2014,도암면,우치리1,29,44,22,22,2025-07-31
2014,도암면,봉하리1,21,39,21,18,2025-07-31
2014,도암면,왕정리1,7,12,7,5,2025-07-31
2014,도암면,행산리1,10,21,10,11,2025-07-31
2014,이서면,"서리,월산리1",16,27,16,11,2025-07-31
2014,이서면,창랑리1,30,42,20,22,2025-07-31
2014,이서면,야사리1,64,129,68,61,2025-07-31
2014,이서면,야사리2,58,117,59,58,2025-07-31
2014,이서면,야사리3,19,45,21,24,2025-07-31
2014,이서면,야사리4,24,40,17,23,2025-07-31
2014,이서면,보월리1,68,127,60,67,2025-07-31
2014,이서면,보월리2,22,32,14,18,2025-07-31
2014,이서면,인계리1,45,78,36,42,2025-07-31
2014,이서면,인계리2,29,62,32,30,2025-07-31
2014,이서면,영평리1,66,126,61,65,2025-07-31
2014,이서면,영평리2,22,28,18,10,2025-07-31
2014,이서면,안심리1,62,119,56,63,2025-07-31
2014,이서면,안심리2,19,40,25,15,2025-07-31
2014,이서면,갈두리1,8,15,10,5,2025-07-31
2014,백아면,임곡리1,61,116,57,59,2025-07-31
2014,백아면,옥리1구1,49,102,45,57,2025-07-31
2014,백아면,옥리2구2,30,48,26,22,2025-07-31
2014,백아면,서유리1구1,60,118,58,60,2025-07-31
2014,백아면,서유리2구2,22,40,19,21,2025-07-31
2014,백아면,맹리1,40,61,34,27,2025-07-31
2014,백아면,남치리1,46,97,45,52,2025-07-31
2014,백아면,원리1,111,210,100,110,2025-07-31
2014,백아면,송단리1구1,32,56,28,28,2025-07-31
2014,백아면,송단리2구2,40,74,37,37,2025-07-31
2014,백아면,방리1,32,56,27,29,2025-07-31
2014,백아면,노기리1,38,72,36,36,2025-07-31
2014,백아면,이천리1구1,49,102,52,50,2025-07-31
2014,백아면,이천리2구2,81,137,68,69,2025-07-31
2014,백아면,길성리1,54,83,39,44,2025-07-31
2014,백아면,와천리1,19,34,16,18,2025-07-31
2014,백아면,다곡리1,67,116,54,62,2025-07-31
2014,백아면,수리1,85,146,65,81,2025-07-31
2014,백아면,노치리1,22,54,28,26,2025-07-31
2014,백아면,용곡리1구1,39,60,28,32,2025-07-31
2014,백아면,용곡리2구2,18,27,13,14,2025-07-31
2014,동복면,독상리1,125,229,107,122,2025-07-31
2014,동복면,칠정리1,51,90,44,46,2025-07-31
2014,동복면,칠정리2,31,52,24,28,2025-07-31
2014,동복면,천변리1,103,219,105,114,2025-07-31
2014,동복면,유천리1,74,126,65,61,2025-07-31
2014,동복면,신율리1,38,80,41,39,2025-07-31
2014,동복면,신율리2,20,41,22,19,2025-07-31
2014,동복면,신율리3,28,52,21,31,2025-07-31
2014,동복면,가수리1,38,82,40,42,2025-07-31
2014,동복면,가수리2,19,43,17,26,2025-07-31
2014,동복면,가수리3,19,31,15,16,2025-07-31
2014,동복면,안성리1,59,109,52,57,2025-07-31
2014,동복면,연월리1,49,80,33,47,2025-07-31
2014,동복면,연월리2,30,50,23,27,2025-07-31
2014,동복면,연월리3,33,56,30,26,2025-07-31
2014,동복면,읍애리1,42,66,34,32,2025-07-31
2014,동복면,연둔리1,42,62,27,35,2025-07-31
2014,동복면,연둔리2,20,32,13,19,2025-07-31
2014,동복면,구암리1,33,73,35,38,2025-07-31
2014,동복면,구암리2,29,52,23,29,2025-07-31
2014,동복면,한천리1,105,177,80,97,2025-07-31
2014,사평면,사평리1,52,103,54,49,2025-07-31
2014,사평면,사평리2,71,145,72,73,2025-07-31
2014,사평면,사평리3,54,127,67,60,2025-07-31
2014,사평면,사평리4,64,140,71,69,2025-07-31
2014,사평면,사평리5,86,146,70,76,2025-07-31
2014,사평면,대곡리1,44,85,44,41,2025-07-31
2014,사평면,대곡리2,23,35,22,13,2025-07-31
2014,사평면,검산리1,40,82,44,38,2025-07-31
2014,사평면,검산리2,19,38,18,20,2025-07-31
2014,사평면,운산리1,30,53,27,26,2025-07-31
2014,사평면,원리1,51,98,40,58,2025-07-31
2014,사평면,원리2,35,63,32,31,2025-07-31
2014,사평면,벽송리1,109,222,109,113,2025-07-31
2014,사평면,벽송리2,28,49,26,23,2025-07-31
2014,사평면,장전리1,51,108,49,59,2025-07-31
2014,사평면,장전리2,31,65,35,30,2025-07-31
2014,사평면,절산리1,72,120,57,63,2025-07-31
2014,사평면,절산리2,41,66,30,36,2025-07-31
2014,사평면,사수리1,26,47,25,22,2025-07-31
2014,사평면,사수리2,31,43,22,21,2025-07-31
2014,사평면,주산리1,22,45,24,21,2025-07-31
2014,사평면,복교리1,9,23,10,13,2025-07-31
2014,사평면,남계리1,57,85,36,49,2025-07-31
2014,사평면,유마리1,23,44,19,25,2025-07-31
2014,사평면,다산리1,55,97,52,45,2025-07-31
2014,사평면,용리1,20,29,12,17,2025-07-31
2014,사평면,용리2,45,76,41,35,2025-07-31
2014,사평면,내리1,29,51,21,30,2025-07-31
2014,사평면,내리2,29,46,23,23,2025-07-31
2014,사평면,내리3,41,79,44,35,2025-07-31
2014,동면,백용리1,39,90,41,49,2025-07-31
2014,동면,백용리2,78,164,83,81,2025-07-31
2014,동면,언도리1,56,90,40,50,2025-07-31
2014,동면,언도리2,59,126,60,66,2025-07-31
2014,동면,서성리1,35,65,34,31,2025-07-31
2014,동면,서성리2,32,61,35,26,2025-07-31
2014,동면,국동리1,43,63,34,29,2025-07-31
2014,동면,청궁리2,71,123,60,63,2025-07-31
2014,동면,마산리1,40,80,44,36,2025-07-31
2014,동면,무포리1,32,58,28,30,2025-07-31
2014,동면,무포리2,21,43,24,19,2025-07-31
2014,동면,경치리1,45,83,35,48,2025-07-31
2014,동면,경치리2,15,27,12,15,2025-07-31
2014,동면,복암리1,65,106,46,60,2025-07-31
2014,동면,복암리2,138,227,133,94,2025-07-31
2014,동면,복암리3,45,71,31,40,2025-07-31
2014,동면,오동리1,149,314,156,158,2025-07-31
2014,동면,오동리2,34,59,36,23,2025-07-31
2014,동면,오동리3,54,112,58,54,2025-07-31
2014,동면,천덕리1,50,95,53,42,2025-07-31
2014,동면,천덕리2,36,84,44,40,2025-07-31
2014,동면,천덕리3,74,163,81,82,2025-07-31
2014,동면,장동리1,151,274,138,136,2025-07-31
2014,동면,장동리2,82,180,77,103,2025-07-31
2014,동면,운농리1,81,147,81,66,2025-07-31
2014,동면,운농리2,71,125,72,53,2025-07-31
2014,동면,운농리3,62,127,69,58,2025-07-31
2014,동면,옥호리1,35,70,35,35,2025-07-31
2014,동면,옥호리2,32,50,25,25,2025-07-31
2014,동면,옥호리3,18,30,17,13,2025-07-31
2014,동면,대포리1,64,111,59,52,2025-07-31
2014,동면,대포리2,39,67,34,33,2025-07-31
2014,동면,대포리3,64,113,60,53,2025-07-31
2015,화순읍,감도리1반,63,145,80,65,2025-07-31
2015,화순읍,감도리2반,43,107,53,54,2025-07-31
2015,화순읍,감도리3반,19,47,22,25,2025-07-31
2015,화순읍,강정리1반,6,13,8,5,2025-07-31
2015,화순읍,계소리1반,167,444,227,217,2025-07-31
2015,화순읍,계소리2반,19,38,19,19,2025-07-31
2015,화순읍,계소리3반,52,115,64,51,2025-07-31
2015,화순읍,계소리4반,255,579,286,293,2025-07-31
2015,화순읍,광덕리1반,250,584,277,307,2025-07-31
2015,화순읍,광덕리2반,179,451,225,226,2025-07-31
2015,화순읍,광덕리3반,65,168,88,80,2025-07-31
2015,화순읍,광덕리4반,530,1593,780,813,2025-07-31
2015,화순읍,광덕리5반,454,1351,656,695,2025-07-31
2015,화순읍,교리1반,295,636,340,296,2025-07-31
2015,화순읍,교리2반,530,1605,822,783,2025-07-31
2015,화순읍,교리3반,178,412,203,209,2025-07-31
2015,화순읍,내평리1반,112,228,121,107,2025-07-31
2015,화순읍,다지리1반,82,240,118,122,2025-07-31
2015,화순읍,다지리2반,88,161,81,80,2025-07-31
2015,화순읍,대리1반,370,941,464,477,2025-07-31
2015,화순읍,대리2반,49,114,56,58,2025-07-31
2015,화순읍,대리3반,55,137,71,66,2025-07-31
2015,화순읍,대리4반,638,1928,919,1009,2025-07-31
2015,화순읍,대리5반,398,993,455,538,2025-07-31
2015,화순읍,대리6반,373,1229,599,630,2025-07-31
2015,화순읍,대리7반,376,734,348,386,2025-07-31
2015,화순읍,도웅리1반,77,154,80,74,2025-07-31
2015,화순읍,도웅리2반,24,40,18,22,2025-07-31
2015,화순읍,동구리1반,31,63,33,30,2025-07-31
2015,화순읍,만연리1반,111,267,141,126,2025-07-31
2015,화순읍,만연리2반,122,298,154,144,2025-07-31
2015,화순읍,만연리3반,911,2294,1088,1206,2025-07-31
2015,화순읍,만연리4반,522,1580,752,828,2025-07-31
2015,화순읍,만연리5반,1045,2559,1190,1369,2025-07-31
2015,화순읍,만연리6반,878,2293,1049,1244,2025-07-31
2015,화순읍,벽라리1반,96,214,104,110,2025-07-31
2015,화순읍,벽라리2반,127,262,130,132,2025-07-31
2015,화순읍,벽라리3반,376,1075,528,547,2025-07-31
2015,화순읍,삼천리1반,109,223,111,112,2025-07-31
2015,화순읍,삼천리2반,70,179,101,78,2025-07-31
2015,화순읍,삼천리3반,38,76,35,41,2025-07-31
2015,화순읍,삼천리4반,438,760,406,354,2025-07-31
2015,화순읍,서태리1반,83,170,89,81,2025-07-31
2015,화순읍,서태리2반,57,98,47,51,2025-07-31
2015,화순읍,세량리1반,48,91,46,45,2025-07-31
2015,화순읍,수만리1반,31,55,30,25,2025-07-31
2015,화순읍,수만리2반,23,32,19,13,2025-07-31
2015,화순읍,수만리3반,59,111,55,56,2025-07-31
2015,화순읍,신기리1반,367,783,430,353,2025-07-31
2015,화순읍,신기리2반,1296,3622,1787,1835,2025-07-31
2015,화순읍,신기리3반,296,707,349,358,2025-07-31
2015,화순읍,앵남리1반,50,95,51,44,2025-07-31
2015,화순읍,앵남리2반,45,72,37,35,2025-07-31
2015,화순읍,연양리1반,51,113,58,55,2025-07-31
2015,화순읍,연양리2반,86,168,93,75,2025-07-31
2015,화순읍,유천리1반,60,153,79,74,2025-07-31
2015,화순읍,유천리2반,43,87,49,38,2025-07-31
2015,화순읍,유천리3반,32,78,34,44,2025-07-31
2015,화순읍,이십곡리,70,153,82,71,2025-07-31
2015,화순읍,이십곡리,32,72,39,33,2025-07-31
2015,화순읍,일심리1반,239,540,272,268,2025-07-31
2015,화순읍,일심리2반,45,93,47,46,2025-07-31
2015,화순읍,일심리3반,40,100,51,49,2025-07-31
2015,화순읍,일심리4반,384,1047,493,554,2025-07-31
2015,화순읍,일심리5반,544,1396,691,705,2025-07-31
2015,화순읍,일심리6반,651,1966,935,1031,2025-07-31
2015,화순읍,주도리1반,37,73,44,29,2025-07-31
2015,화순읍,주도리2반,57,104,47,57,2025-07-31
2015,화순읍,주도리3반,50,100,51,49,2025-07-31
2015,화순읍,향청리1반,248,513,264,249,2025-07-31
2015,화순읍,훈리1반,176,441,223,218,2025-07-31
2015,한천면,모산1,102,192,100,92,2025-07-31
2015,한천면,모산2,21,29,16,13,2025-07-31
2015,한천면,금전리,46,80,43,37,2025-07-31
2015,한천면,한계1,103,195,100,95,2025-07-31
2015,한천면,한계2,55,113,53,60,2025-07-31
2015,한천면,정리1,26,44,26,18,2025-07-31
2015,한천면,정리2,30,68,34,34,2025-07-31
2015,한천면,가암1,29,56,29,27,2025-07-31
2015,한천면,가암2,40,58,23,35,2025-07-31
2015,한천면,오음1,39,73,34,39,2025-07-31
2015,한천면,오음2,29,60,31,29,2025-07-31
2015,한천면,오음3,23,36,19,17,2025-07-31
2015,한천면,반곡1,32,60,29,31,2025-07-31
2015,한천면,반곡2,37,55,30,25,2025-07-31
2015,한천면,평리,52,95,44,51,2025-07-31
2015,한천면,정우리,44,73,31,42,2025-07-31
2015,한천면,동가1,64,113,57,56,2025-07-31
2015,한천면,동가2,28,63,31,32,2025-07-31
2015,한천면,고시리,7,12,9,3,2025-07-31
2015,춘양면,석정리,227,445,235,210,2025-07-31
2015,춘양면,화림리1,24,56,26,30,2025-07-31
2015,춘양면,화림리2,56,98,48,50,2025-07-31
2015,춘양면,화림리3,32,64,27,37,2025-07-31
2015,춘양면,대신리1,37,72,42,30,2025-07-31
2015,춘양면,대신리2,25,41,19,22,2025-07-31
2015,춘양면,대신리3,35,59,30,29,2025-07-31
2015,춘양면,회송리1,35,60,26,34,2025-07-31
2015,춘양면,회송리2,28,50,31,19,2025-07-31
2015,춘양면,양곡리1,49,93,48,45,2025-07-31
2015,춘양면,용곡리1,57,101,53,48,2025-07-31
2015,춘양면,월평리1,32,71,31,40,2025-07-31
2015,춘양면,월평리2,22,38,17,21,2025-07-31
2015,춘양면,월평리3,19,30,17,13,2025-07-31
2015,춘양면,변천리1,57,95,46,49,2025-07-31
2015,춘양면,가동리1,12,17,8,9,2025-07-31
2015,춘양면,산간리1,58,94,38,56,2025-07-31
2015,춘양면,가봉리1,77,135,66,69,2025-07-31
2015,춘양면,용두리1,41,67,26,41,2025-07-31
2015,춘양면,우봉리1,80,189,97,92,2025-07-31
2015,춘양면,부곡리1,27,50,21,29,2025-07-31
2015,춘양면,부곡리2,26,42,18,24,2025-07-31
2015,춘양면,부곡리3,23,50,27,23,2025-07-31
2015,청풍면,풍암리1,76,131,58,73,2025-07-31
2015,청풍면,한지리1,43,65,29,36,2025-07-31
2015,청풍면,한지리2,29,54,23,31,2025-07-31
2015,청풍면,어리1,47,79,38,41,2025-07-31
2015,청풍면,세청리1,57,103,48,55,2025-07-31
2015,청풍면,세청리2,19,28,13,15,2025-07-31
2015,청풍면,대비리1,43,70,35,35,2025-07-31
2015,청풍면,백운리1,41,71,32,39,2025-07-31
2015,청풍면,청용리1,36,56,25,31,2025-07-31
2015,청풍면,이만리1,20,28,14,14,2025-07-31
2015,청풍면,신석리1,22,31,14,17,2025-07-31
2015,청풍면,신석리2,21,40,21,19,2025-07-31
2015,청풍면,신리1,45,76,37,39,2025-07-31
2015,청풍면,신리2,36,62,32,30,2025-07-31
2015,청풍면,차리1,30,54,21,33,2025-07-31
2015,청풍면,차리2,101,181,92,89,2025-07-31
2015,이양면,금능1,85,182,81,101,2025-07-31
2015,이양면,강성리1,38,61,26,35,2025-07-31
2015,이양면,강성리2,31,54,28,26,2025-07-31
2015,이양면,강성리3,28,51,26,25,2025-07-31
2015,이양면,용반리1,32,51,21,30,2025-07-31
2015,이양면,장치리1,16,20,9,11,2025-07-31
2015,이양면,묵곡리1,27,46,23,23,2025-07-31
2015,이양면,묵곡리2,25,55,29,26,2025-07-31
2015,이양면,옥리1,18,38,18,20,2025-07-31
2015,이양면,품평리1,46,64,27,37,2025-07-31
2015,이양면,품평리2,35,89,43,46,2025-07-31
2015,이양면,품평리3,38,74,38,36,2025-07-31
2015,이양면,오류리1,96,180,93,87,2025-07-31
2015,이양면,오류리2,36,67,34,33,2025-07-31
2015,이양면,오류리3,45,86,41,45,2025-07-31
2015,이양면,오류리4,25,44,22,22,2025-07-31
2015,이양면,이양리1,54,84,38,46,2025-07-31
2015,이양면,이양리2,62,117,53,64,2025-07-31
2015,이양면,율계리1,48,81,41,40,2025-07-31
2015,이양면,송정리1,19,33,15,18,2025-07-31
2015,이양면,송정리2,25,43,25,18,2025-07-31
2015,이양면,초방리1,31,49,24,25,2025-07-31
2015,이양면,초방리2,22,37,15,22,2025-07-31
2015,이양면,매정리1,22,38,21,17,2025-07-31
2015,이양면,매정리2,33,58,27,31,2025-07-31
2015,이양면,연화리1,28,42,26,16,2025-07-31
2015,이양면,구례리1,33,58,26,32,2025-07-31
2015,이양면,쌍봉리1,71,116,56,60,2025-07-31
2015,이양면,증리1,27,43,23,20,2025-07-31
2015,능주면,남정리1,133,281,156,125,2025-07-31
2015,능주면,남정리2,35,60,24,36,2025-07-31
2015,능주면,정남리1,78,167,78,89,2025-07-31
2015,능주면,석고리1,187,374,184,190,2025-07-31
2015,능주면,잠정리1,165,357,162,195,2025-07-31
2015,능주면,잠정리2,239,639,326,313,2025-07-31
2015,능주면,내리1,27,50,28,22,2025-07-31
2015,능주면,관영리1,268,578,281,297,2025-07-31
2015,능주면,천덕리1,68,117,61,56,2025-07-31
2015,능주면,천덕리2,46,85,36,49,2025-07-31
2015,능주면,만인리1,68,153,82,71,2025-07-31
2015,능주면,광사리1,49,92,50,42,2025-07-31
2015,능주면,백암리1,104,179,94,85,2025-07-31
2015,능주면,백암리2,45,97,44,53,2025-07-31
2015,능주면,만수리1,60,137,62,75,2025-07-31
2015,능주면,만수리2,45,98,47,51,2025-07-31
2015,능주면,원지리1,98,178,84,94,2025-07-31
2015,도곡면,대곡리1반,41,84,41,43,2025-07-31
2015,도곡면,대곡리2반,52,100,52,48,2025-07-31
2015,도곡면,대곡리3반,72,129,65,64,2025-07-31
2015,도곡면,효산리1반,153,301,160,141,2025-07-31
2015,도곡면,효산리2반,78,146,69,77,2025-07-31
2015,도곡면,월곡리1반,39,88,43,45,2025-07-31
2015,도곡면,월곡리2반,49,89,36,53,2025-07-31
2015,도곡면,월곡리3반,39,71,34,37,2025-07-31
2015,도곡면,쌍옥리1반,70,147,65,82,2025-07-31
2015,도곡면,쌍옥리2반,60,105,51,54,2025-07-31
2015,도곡면,평리1반,82,158,76,82,2025-07-31
2015,도곡면,덕곡리1반,39,57,26,31,2025-07-31
2015,도곡면,덕곡리2반,31,71,39,32,2025-07-31
2015,도곡면,신성리1반,50,92,46,46,2025-07-31
2015,도곡면,신성리2반,45,90,45,45,2025-07-31
2015,도곡면,천암리1반,232,489,248,241,2025-07-31
2015,도곡면,원화리1반,70,144,70,74,2025-07-31
2015,도곡면,원화리2반,51,85,45,40,2025-07-31
2015,도곡면,신덕리1반,54,111,57,54,2025-07-31
2015,도곡면,신덕리2반,40,70,29,41,2025-07-31
2015,도곡면,신덕리3반,43,92,42,50,2025-07-31
2015,도곡면,미곡리1반,32,66,32,34,2025-07-31
2015,도곡면,미곡리2반,48,87,46,41,2025-07-31
2015,도곡면,족청리1반,83,163,90,73,2025-07-31
2015,도곡면,족청리2반,24,38,17,21,2025-07-31
2015,도암면,운월리1,39,66,34,32,2025-07-31
2015,도암면,운월리2,30,57,28,29,2025-07-31
2015,도암면,도장리1,57,132,61,71,2025-07-31
2015,도암면,벽지리1,33,55,24,31,2025-07-31
2015,도암면,벽지리1,22,55,31,24,2025-07-31
2015,도암면,정천리1,79,142,76,66,2025-07-31
2015,도암면,원천리1,51,85,48,37,2025-07-31
2015,도암면,원천리2,24,44,25,19,2025-07-31
2015,도암면,원천리3,60,112,57,55,2025-07-31
2015,도암면,천태리1,39,76,38,38,2025-07-31
2015,도암면,천태리2,44,84,42,42,2025-07-31
2015,도암면,지월리1,19,43,27,16,2025-07-31
2015,도암면,지월리2,44,82,38,44,2025-07-31
2015,도암면,지월리3,12,15,6,9,2025-07-31
2015,도암면,등광리1,57,91,52,39,2025-07-31
2015,도암면,대초리1,32,55,32,23,2025-07-31
2015,도암면,용강리1,48,79,40,39,2025-07-31
2015,도암면,용강리2,29,45,23,22,2025-07-31
2015,도암면,용강리3,37,76,41,35,2025-07-31
2015,도암면,호암리1,22,37,20,17,2025-07-31
2015,도암면,호암리2,21,36,18,18,2025-07-31
2015,도암면,우치리1,29,43,21,22,2025-07-31
2015,도암면,봉하리1,27,46,27,19,2025-07-31
2015,도암면,왕정리1,8,13,8,5,2025-07-31
2015,도암면,행산리1,10,18,9,9,2025-07-31
2015,이서면,"서리,월산리1",19,27,17,10,2025-07-31
2015,이서면,창랑리1,31,41,20,21,2025-07-31
2015,이서면,야사리1,64,131,68,63,2025-07-31
2015,이서면,야사리2,61,114,54,60,2025-07-31
2015,이서면,야사리3,20,38,19,19,2025-07-31
2015,이서면,야사리4,27,48,24,24,2025-07-31
2015,이서면,보월리1,65,117,59,58,2025-07-31
2015,이서면,보월리2,22,31,13,18,2025-07-31
2015,이서면,인계리1,27,41,23,18,2025-07-31
2015,이서면,인계리2,31,70,39,31,2025-07-31
2015,이서면,인계리3,20,34,13,21,2025-07-31
2015,이서면,영평리1,67,120,60,60,2025-07-31
2015,이서면,영평리2,22,32,20,12,2025-07-31
2015,이서면,안심리1,61,111,51,60,2025-07-31
2015,이서면,안심리2,19,41,25,16,2025-07-31
2015,이서면,갈두리1,7,14,9,5,2025-07-31
2015,백아면,임곡리1,62,121,59,62,2025-07-31
2015,백아면,옥리1구1,54,103,48,55,2025-07-31
2015,백아면,옥리2구2,28,47,26,21,2025-07-31
2015,백아면,서유리1구1,59,108,53,55,2025-07-31
2015,백아면,서유리2구2,23,38,19,19,2025-07-31
2015,백아면,맹리1,39,58,34,24,2025-07-31
2015,백아면,남치리1,49,94,42,52,2025-07-31
2015,백아면,원리1,113,211,99,112,2025-07-31
2015,백아면,송단리1구1,31,56,28,28,2025-07-31
2015,백아면,송단리2구2,44,79,42,37,2025-07-31
2015,백아면,방리1,32,56,27,29,2025-07-31
2015,백아면,노기리1,37,70,34,36,2025-07-31
2015,백아면,이천리1구1,48,99,50,49,2025-07-31
2015,백아면,이천리2구2,82,127,65,62,2025-07-31
2015,백아면,길성리1,52,78,35,43,2025-07-31
2015,백아면,와천리1,18,36,17,19,2025-07-31
2015,백아면,다곡리1,67,102,46,56,2025-07-31
2015,백아면,수리1,85,148,69,79,2025-07-31
2015,백아면,노치리1,19,52,31,21,2025-07-31
2015,백아면,용곡리1구1,37,56,26,30,2025-07-31
2015,백아면,용곡리2구2,19,24,10,14,2025-07-31
2015,동복면,독상리1,123,230,104,126,2025-07-31
2015,동복면,칠정리1,50,89,44,45,2025-07-31
2015,동복면,칠정리2,30,49,22,27,2025-07-31
2015,동복면,천변리1,97,210,98,112,2025-07-31
2015,동복면,유천리1,78,129,63,66,2025-07-31
2015,동복면,신율리1,39,78,41,37,2025-07-31
2015,동복면,신율리2,20,39,21,18,2025-07-31
2015,동복면,신율리3,30,57,24,33,2025-07-31
2015,동복면,가수리1,38,81,39,42,2025-07-31
2015,동복면,가수리2,19,42,17,25,2025-07-31
2015,동복면,가수리3,19,32,15,17,2025-07-31
2015,동복면,안성리1,33,59,29,30,2025-07-31
2015,동복면,안성리2,26,43,20,23,2025-07-31
2015,동복면,연월리1,47,72,28,44,2025-07-31
2015,동복면,연월리2,30,53,23,30,2025-07-31
2015,동복면,연월리3,34,56,29,27,2025-07-31
2015,동복면,읍애리1,39,64,33,31,2025-07-31
2015,동복면,연둔리1,36,54,23,31,2025-07-31
2015,동복면,연둔리2,20,32,13,19,2025-07-31
2015,동복면,구암리1,32,72,34,38,2025-07-31
2015,동복면,구암리2,29,53,23,30,2025-07-31
2015,동복면,한천리1,110,179,79,100,2025-07-31
2015,사평면,사평리1,51,104,52,52,2025-07-31
2015,사평면,사평리2,70,137,67,70,2025-07-31
2015,사평면,사평리3,57,125,64,61,2025-07-31
2015,사평면,사평리4,63,127,64,63,2025-07-31
2015,사평면,사평리5,80,131,60,71,2025-07-31
2015,사평면,대곡리1,41,86,45,41,2025-07-31
2015,사평면,대곡리2,24,35,21,14,2025-07-31
2015,사평면,검산리1,39,77,42,35,2025-07-31
2015,사평면,검산리2,19,35,18,17,2025-07-31
2015,사평면,운산리1,31,51,25,26,2025-07-31
2015,사평면,원리1,52,100,42,58,2025-07-31
2015,사평면,원리2,35,67,35,32,2025-07-31
2015,사평면,벽송리1,110,205,99,106,2025-07-31
2015,사평면,벽송리2,29,52,29,23,2025-07-31
2015,사평면,장전리1,52,106,47,59,2025-07-31
2015,사평면,장전리2,34,71,38,33,2025-07-31
2015,사평면,절산리1,71,123,58,65,2025-07-31
2015,사평면,절산리2,44,71,29,42,2025-07-31
2015,사평면,사수리1,27,47,25,22,2025-07-31
2015,사평면,사수리2,29,42,23,19,2025-07-31
2015,사평면,주산리1,27,52,25,27,2025-07-31
2015,사평면,복교리1,8,22,10,12,2025-07-31
2015,사평면,남계리1,56,82,35,47,2025-07-31
2015,사평면,유마리1,25,48,20,28,2025-07-31
2015,사평면,다산리1,58,92,48,44,2025-07-31
2015,사평면,용리1,19,27,12,15,2025-07-31
2015,사평면,용리2,46,80,40,40,2025-07-31
2015,사평면,내리1,28,49,21,28,2025-07-31
2015,사평면,내리2,27,43,20,23,2025-07-31
2015,사평면,내리3,37,67,39,28,2025-07-31
2015,동면,백용리1,37,87,39,48,2025-07-31
2015,동면,백용리2,82,168,90,78,2025-07-31
2015,동면,언도리1,57,96,45,51,2025-07-31
2015,동면,언도리2,63,134,67,67,2025-07-31
2015,동면,서성리1,32,68,31,37,2025-07-31
2015,동면,서성리2,32,71,35,36,2025-07-31
2015,동면,국동리1,45,72,36,36,2025-07-31
2015,동면,청궁리2,76,128,59,69,2025-07-31
2015,동면,마산리1,46,115,64,51,2025-07-31
2015,동면,무포리1,32,57,29,28,2025-07-31
2015,동면,무포리2,20,43,24,19,2025-07-31
2015,동면,경치리1,44,84,37,47,2025-07-31
2015,동면,경치리2,16,29,12,17,2025-07-31
2015,동면,복암리1,66,103,46,57,2025-07-31
2015,동면,복암리2,147,250,138,112,2025-07-31
2015,동면,복암리3,47,63,31,32,2025-07-31
2015,동면,오동리1,151,312,154,158,2025-07-31
2015,동면,오동리2,34,59,30,29,2025-07-31
2015,동면,오동리3,52,111,54,57,2025-07-31
2015,동면,천덕리1,49,92,57,35,2025-07-31
2015,동면,천덕리2,40,86,47,39,2025-07-31
2015,동면,천덕리3,77,171,79,92,2025-07-31
2015,동면,장동리1,151,276,134,142,2025-07-31
2015,동면,장동리2,83,180,77,103,2025-07-31
2015,동면,운농리1,82,142,75,67,2025-07-31
2015,동면,운농리2,65,115,66,49,2025-07-31
2015,동면,운농리3,62,129,68,61,2025-07-31
2015,동면,옥호리1,38,73,36,37,2025-07-31
2015,동면,옥호리2,31,51,26,25,2025-07-31
2015,동면,옥호리3,18,34,18,16,2025-07-31
2015,동면,대포리1,58,99,50,49,2025-07-31
2015,동면,대포리2,39,65,31,34,2025-07-31
2015,동면,대포리3,64,123,65,58,2025-07-31
2016,화순읍,감도리1반,66,149,81,68,2025-07-31
2016,화순읍,감도리2반,47,110,54,56,2025-07-31
2016,화순읍,감도리3반,20,46,21,25,2025-07-31
2016,화순읍,강정리1반,6,13,8,5,2025-07-31
2016,화순읍,계소리1반,152,399,201,198,2025-07-31
2016,화순읍,계소리2반,16,36,18,18,2025-07-31
2016,화순읍,계소리3반,51,109,60,49,2025-07-31
2016,화순읍,계소리4반,253,568,279,289,2025-07-31
2016,화순읍,광덕리1반,248,581,273,308,2025-07-31
2016,화순읍,광덕리2반,177,429,204,225,2025-07-31
2016,화순읍,광덕리3반,66,155,81,74,2025-07-31
2016,화순읍,광덕리4반,527,1565,776,789,2025-07-31
2016,화순읍,광덕리5반,441,1313,636,677,2025-07-31
2016,화순읍,교리1반,275,596,317,279,2025-07-31
2016,화순읍,교리2반,530,1563,796,767,2025-07-31
2016,화순읍,교리3반,182,396,193,203,2025-07-31
2016,화순읍,내평리1반,108,225,118,107,2025-07-31
2016,화순읍,다지리1반,85,236,114,122,2025-07-31
2016,화순읍,다지리2반,84,143,74,69,2025-07-31
2016,화순읍,대리1반,362,897,446,451,2025-07-31
2016,화순읍,대리2반,47,113,57,56,2025-07-31
2016,화순읍,대리3반,60,146,77,69,2025-07-31
2016,화순읍,대리4반,967,2910,1403,1507,2025-07-31
2016,화순읍,대리5반,398,964,442,522,2025-07-31
2016,화순읍,대리6반,374,1225,597,628,2025-07-31
2016,화순읍,대리7반,373,675,323,352,2025-07-31
2016,화순읍,도웅리1반,80,150,78,72,2025-07-31
2016,화순읍,도웅리2반,22,37,17,20,2025-07-31
2016,화순읍,동구리1반,27,54,29,25,2025-07-31
2016,화순읍,만연리1반,111,252,132,120,2025-07-31
2016,화순읍,만연리2반,121,273,138,135,2025-07-31
2016,화순읍,만연리3반,891,2135,998,1137,2025-07-31
2016,화순읍,만연리4반,502,1495,701,794,2025-07-31
2016,화순읍,만연리5반,1042,2476,1137,1339,2025-07-31
2016,화순읍,만연리6반,844,2136,999,1137,2025-07-31
2016,화순읍,벽라리1반,92,200,93,107,2025-07-31
2016,화순읍,벽라리2반,118,243,123,120,2025-07-31
2016,화순읍,벽라리3반,374,1032,509,523,2025-07-31
2016,화순읍,삼천리1반,111,230,112,118,2025-07-31
2016,화순읍,삼천리2반,241,739,364,375,2025-07-31
2016,화순읍,삼천리3반,34,74,34,40,2025-07-31
2016,화순읍,삼천리4반,453,772,406,366,2025-07-31
2016,화순읍,서태리1반,84,171,86,85,2025-07-31
2016,화순읍,서태리2반,52,87,41,46,2025-07-31
2016,화순읍,세량리1반,44,82,42,40,2025-07-31
2016,화순읍,수만리1반,33,55,31,24,2025-07-31
2016,화순읍,수만리2반,23,30,19,11,2025-07-31
2016,화순읍,수만리3반,57,106,56,50,2025-07-31
2016,화순읍,신기리1반,374,792,431,361,2025-07-31
2016,화순읍,신기리2반,1254,3445,1693,1752,2025-07-31
2016,화순읍,신기리3반,269,640,321,319,2025-07-31
2016,화순읍,앵남리1반,52,95,50,45,2025-07-31
2016,화순읍,앵남리2반,44,73,39,34,2025-07-31
2016,화순읍,연양리1반,50,94,45,49,2025-07-31
2016,화순읍,연양리2반,83,150,84,66,2025-07-31
2016,화순읍,유천리1반,62,162,84,78,2025-07-31
2016,화순읍,유천리2반,46,95,52,43,2025-07-31
2016,화순읍,유천리3반,33,80,38,42,2025-07-31
2016,화순읍,이십곡리,77,161,88,73,2025-07-31
2016,화순읍,이십곡리,33,70,36,34,2025-07-31
2016,화순읍,일심리1반,222,502,257,245,2025-07-31
2016,화순읍,일심리2반,38,79,42,37,2025-07-31
2016,화순읍,일심리3반,48,110,52,58,2025-07-31
2016,화순읍,일심리4반,375,961,463,498,2025-07-31
2016,화순읍,일심리5반,555,1341,668,673,2025-07-31
2016,화순읍,일심리6반,630,1899,899,1000,2025-07-31
2016,화순읍,주도리1반,37,70,40,30,2025-07-31
2016,화순읍,주도리2반,53,94,43,51,2025-07-31
2016,화순읍,주도리3반,48,94,47,47,2025-07-31
2016,화순읍,향청리1반,226,481,247,234,2025-07-31
2016,화순읍,훈리1반,166,410,208,202,2025-07-31
2016,한천면,모산1,101,185,95,90,2025-07-31
2016,한천면,모산2,23,31,18,13,2025-07-31
2016,한천면,금전리,47,86,46,40,2025-07-31
2016,한천면,한계1,99,180,91,89,2025-07-31
2016,한천면,한계2,54,109,53,56,2025-07-31
2016,한천면,정리1,27,44,28,16,2025-07-31
2016,한천면,정리2,28,62,29,33,2025-07-31
2016,한천면,가암1,29,57,29,28,2025-07-31
2016,한천면,가암2,40,60,26,34,2025-07-31
2016,한천면,오음1,37,64,30,34,2025-07-31
2016,한천면,오음2,26,57,30,27,2025-07-31
2016,한천면,오음3,22,32,17,15,2025-07-31
2016,한천면,반곡1,31,59,28,31,2025-07-31
2016,한천면,반곡2,37,54,29,25,2025-07-31
2016,한천면,평리,52,91,41,50,2025-07-31
2016,한천면,정우리,41,67,29,38,2025-07-31
2016,한천면,동가1,67,113,56,57,2025-07-31
2016,한천면,동가2,27,62,30,32,2025-07-31
2016,한천면,고시리,7,13,10,3,2025-07-31
2016,춘양면,석정리,218,432,221,211,2025-07-31
2016,춘양면,화림리1,27,55,26,29,2025-07-31
2016,춘양면,화림리2,54,94,45,49,2025-07-31
2016,춘양면,화림리3,33,62,25,37,2025-07-31
2016,춘양면,대신리1,36,72,42,30,2025-07-31
2016,춘양면,대신리2,24,39,19,20,2025-07-31
2016,춘양면,대신리3,37,62,33,29,2025-07-31
2016,춘양면,회송리1,34,54,23,31,2025-07-31
2016,춘양면,회송리2,32,57,37,20,2025-07-31
2016,춘양면,양곡리1,48,89,47,42,2025-07-31
2016,춘양면,용곡리1,57,101,57,44,2025-07-31
2016,춘양면,월평리1,33,70,31,39,2025-07-31
2016,춘양면,월평리2,22,40,18,22,2025-07-31
2016,춘양면,월평리3,19,31,15,16,2025-07-31
2016,춘양면,변천리1,52,85,42,43,2025-07-31
2016,춘양면,가동리1,11,12,6,6,2025-07-31
2016,춘양면,산간리1,59,99,42,57,2025-07-31
2016,춘양면,가봉리1,78,146,71,75,2025-07-31
2016,춘양면,용두리1,43,67,29,38,2025-07-31
2016,춘양면,우봉리1,82,196,98,98,2025-07-31
2016,춘양면,부곡리1,27,50,20,30,2025-07-31
2016,춘양면,부곡리2,25,41,15,26,2025-07-31
2016,춘양면,부곡리3,23,49,25,24,2025-07-31
2016,청풍면,풍암리1,74,134,61,73,2025-07-31
2016,청풍면,한지리1,40,60,24,36,2025-07-31
2016,청풍면,한지리2,30,54,24,30,2025-07-31
2016,청풍면,어리1,46,76,37,39,2025-07-31
2016,청풍면,세청리1,59,103,47,56,2025-07-31
2016,청풍면,세청리2,19,25,10,15,2025-07-31
2016,청풍면,대비리1,42,67,31,36,2025-07-31
2016,청풍면,백운리1,47,79,37,42,2025-07-31
2016,청풍면,청용리1,37,54,25,29,2025-07-31
2016,청풍면,이만리1,18,26,15,11,2025-07-31
2016,청풍면,신석리1,22,33,15,18,2025-07-31
2016,청풍면,신석리2,22,41,22,19,2025-07-31
2016,청풍면,신리1,47,74,35,39,2025-07-31
2016,청풍면,신리2,34,58,28,30,2025-07-31
2016,청풍면,차리1,27,43,17,26,2025-07-31
2016,청풍면,차리2,101,178,93,85,2025-07-31
2016,이양면,금능1,86,183,83,100,2025-07-31
2016,이양면,강성리1,38,62,27,35,2025-07-31
2016,이양면,강성리2,30,55,26,29,2025-07-31
2016,이양면,강성리3,29,53,27,26,2025-07-31
2016,이양면,용반리1,33,50,19,31,2025-07-31
2016,이양면,장치리1,16,20,9,11,2025-07-31
2016,이양면,묵곡리1,27,48,27,21,2025-07-31
2016,이양면,묵곡리2,24,51,25,26,2025-07-31
2016,이양면,옥리1,18,37,19,18,2025-07-31
2016,이양면,품평리1,48,65,28,37,2025-07-31
2016,이양면,품평리2,36,88,43,45,2025-07-31
2016,이양면,품평리3,40,77,37,40,2025-07-31
2016,이양면,오류리1,94,178,92,86,2025-07-31
2016,이양면,오류리2,38,65,32,33,2025-07-31
2016,이양면,오류리3,47,91,46,45,2025-07-31
2016,이양면,오류리4,26,39,20,19,2025-07-31
2016,이양면,이양리1,57,85,37,48,2025-07-31
2016,이양면,이양리2,60,108,49,59,2025-07-31
2016,이양면,율계리1,49,80,39,41,2025-07-31
2016,이양면,송정리1,22,35,16,19,2025-07-31
2016,이양면,송정리2,24,46,24,22,2025-07-31
2016,이양면,초방리1,30,48,22,26,2025-07-31
2016,이양면,초방리2,26,43,21,22,2025-07-31
2016,이양면,매정리1,24,40,21,19,2025-07-31
2016,이양면,매정리2,28,66,33,33,2025-07-31
2016,이양면,연화리1,29,43,25,18,2025-07-31
2016,이양면,구례리1,29,50,22,28,2025-07-31
2016,이양면,쌍봉리1,68,117,57,60,2025-07-31
2016,이양면,증리1,31,49,27,22,2025-07-31
2016,능주면,남정리1,136,282,156,126,2025-07-31
2016,능주면,남정리2,34,56,24,32,2025-07-31
2016,능주면,정남리1,75,158,71,87,2025-07-31
2016,능주면,석고리1,188,375,187,188,2025-07-31
2016,능주면,잠정리1,156,347,167,180,2025-07-31
2016,능주면,잠정리2,246,650,331,319,2025-07-31
2016,능주면,내리1,24,46,26,20,2025-07-31
2016,능주면,관영리1,263,541,260,281,2025-07-31
2016,능주면,천덕리1,65,110,60,50,2025-07-31
2016,능주면,천덕리2,46,86,37,49,2025-07-31
2016,능주면,만인리1,69,151,84,67,2025-07-31
2016,능주면,광사리1,50,92,52,40,2025-07-31
2016,능주면,백암리1,105,176,93,83,2025-07-31
2016,능주면,백암리2,44,93,43,50,2025-07-31
2016,능주면,만수리1,57,130,58,72,2025-07-31
2016,능주면,만수리2,45,96,48,48,2025-07-31
2016,능주면,원지리1,96,175,84,91,2025-07-31
2016,도곡면,대곡리1반,40,80,38,42,2025-07-31
2016,도곡면,대곡리2반,51,95,50,45,2025-07-31
2016,도곡면,대곡리3반,74,136,70,66,2025-07-31
2016,도곡면,효산리1반,147,285,151,134,2025-07-31
2016,도곡면,효산리2반,77,145,66,79,2025-07-31
2016,도곡면,월곡리1반,43,86,42,44,2025-07-31
2016,도곡면,월곡리2반,47,86,35,51,2025-07-31
2016,도곡면,월곡리3반,36,67,34,33,2025-07-31
2016,도곡면,쌍옥리1반,73,145,62,83,2025-07-31
2016,도곡면,쌍옥리2반,62,108,51,57,2025-07-31
2016,도곡면,평리1반,82,165,78,87,2025-07-31
2016,도곡면,덕곡리1반,41,57,26,31,2025-07-31
2016,도곡면,덕곡리2반,32,68,40,28,2025-07-31
2016,도곡면,신성리1반,54,95,48,47,2025-07-31
2016,도곡면,신성리2반,42,83,42,41,2025-07-31
2016,도곡면,천암리1반,230,470,237,233,2025-07-31
2016,도곡면,원화리1반,76,143,73,70,2025-07-31
2016,도곡면,원화리2반,51,93,50,43,2025-07-31
2016,도곡면,신덕리1반,55,111,57,54,2025-07-31
2016,도곡면,신덕리2반,39,65,29,36,2025-07-31
2016,도곡면,신덕리3반,38,75,34,41,2025-07-31
2016,도곡면,미곡리1반,36,68,36,32,2025-07-31
2016,도곡면,미곡리2반,47,87,41,46,2025-07-31
2016,도곡면,족청리1반,80,158,83,75,2025-07-31
2016,도곡면,족청리2반,26,39,16,23,2025-07-31
2016,도암면,운월리1,39,66,32,34,2025-07-31
2016,도암면,운월리2,28,55,28,27,2025-07-31
2016,도암면,도장리1,60,127,60,67,2025-07-31
2016,도암면,벽지리1,29,47,22,25,2025-07-31
2016,도암면,벽지리1,22,52,31,21,2025-07-31
2016,도암면,정천리1,80,137,72,65,2025-07-31
2016,도암면,원천리1,58,97,51,46,2025-07-31
2016,도암면,원천리2,23,43,24,19,2025-07-31
2016,도암면,원천리3,57,100,49,51,2025-07-31
2016,도암면,천태리1,40,82,41,41,2025-07-31
2016,도암면,천태리2,44,75,36,39,2025-07-31
2016,도암면,지월리1,17,37,22,15,2025-07-31
2016,도암면,지월리2,36,62,27,35,2025-07-31
2016,도암면,지월리3,18,33,14,19,2025-07-31
2016,도암면,등광리1,54,88,49,39,2025-07-31
2016,도암면,대초리1,33,54,30,24,2025-07-31
2016,도암면,용강리1,49,73,37,36,2025-07-31
2016,도암면,용강리2,28,46,21,25,2025-07-31
2016,도암면,용강리3,38,73,40,33,2025-07-31
2016,도암면,호암리1,24,37,19,18,2025-07-31
2016,도암면,호암리2,22,37,17,20,2025-07-31
2016,도암면,우치리1,27,38,18,20,2025-07-31
2016,도암면,봉하리1,27,46,27,19,2025-07-31
2016,도암면,왕정리1,8,13,9,4,2025-07-31
2016,도암면,행산리1,11,18,9,9,2025-07-31
2016,이서면,"서리,월산리1",21,26,17,9,2025-07-31
2016,이서면,창랑리1,29,43,21,22,2025-07-31
2016,이서면,야사리1,61,123,63,60,2025-07-31
2016,이서면,야사리2,62,103,48,55,2025-07-31
2016,이서면,야사리3,18,36,17,19,2025-07-31
2016,이서면,야사리4,28,47,23,24,2025-07-31
2016,이서면,보월리1,65,116,60,56,2025-07-31
2016,이서면,보월리2,26,34,16,18,2025-07-31
2016,이서면,인계리1,25,41,23,18,2025-07-31
2016,이서면,인계리2,31,69,36,33,2025-07-31
2016,이서면,인계리3,20,34,13,21,2025-07-31
2016,이서면,영평리1,65,123,59,64,2025-07-31
2016,이서면,영평리2,22,32,20,12,2025-07-31
2016,이서면,안심리1,62,107,50,57,2025-07-31
2016,이서면,안심리2,19,39,24,15,2025-07-31
2016,이서면,갈두리1,8,17,9,8,2025-07-31
2016,백아면,임곡리1,57,112,56,56,2025-07-31
2016,백아면,옥리1구1,55,101,49,52,2025-07-31
2016,백아면,옥리2구2,28,44,24,20,2025-07-31
2016,백아면,서유리1구1,59,98,48,50,2025-07-31
2016,백아면,서유리2구2,25,40,21,19,2025-07-31
2016,백아면,맹리1,38,55,33,22,2025-07-31
2016,백아면,남치리1,49,92,40,52,2025-07-31
2016,백아면,원리1,107,205,97,108,2025-07-31
2016,백아면,송단리1구1,30,52,26,26,2025-07-31
2016,백아면,송단리2구2,46,78,43,35,2025-07-31
2016,백아면,방리1,31,56,30,26,2025-07-31
2016,백아면,노기리1,34,63,31,32,2025-07-31
2016,백아면,이천리1구1,46,90,45,45,2025-07-31
2016,백아면,이천리2구2,78,120,64,56,2025-07-31
2016,백아면,길성리1,50,77,35,42,2025-07-31
2016,백아면,와천리1,17,33,17,16,2025-07-31
2016,백아면,다곡리1,64,97,46,51,2025-07-31
2016,백아면,수리1,87,153,70,83,2025-07-31
2016,백아면,노치리1,21,53,29,24,2025-07-31
2016,백아면,용곡리1구1,40,58,30,28,2025-07-31
2016,백아면,용곡리2구2,18,25,10,15,2025-07-31
2016,동복면,독상리1,125,229,104,125,2025-07-31
2016,동복면,칠정리1,53,93,50,43,2025-07-31
2016,동복면,칠정리2,30,52,22,30,2025-07-31
2016,동복면,천변리1,98,207,95,112,2025-07-31
2016,동복면,유천리1,78,126,62,64,2025-07-31
2016,동복면,신율리1,39,74,37,37,2025-07-31
2016,동복면,신율리2,22,41,22,19,2025-07-31
2016,동복면,신율리3,32,58,27,31,2025-07-31
2016,동복면,가수리1,41,84,43,41,2025-07-31
2016,동복면,가수리2,19,39,16,23,2025-07-31
2016,동복면,가수리3,18,29,14,15,2025-07-31
2016,동복면,안성리1,22,45,24,21,2025-07-31
2016,동복면,안성리2,38,60,31,29,2025-07-31
2016,동복면,연월리1,44,68,26,42,2025-07-31
2016,동복면,연월리2,32,59,26,33,2025-07-31
2016,동복면,연월리3,34,55,30,25,2025-07-31
2016,동복면,읍애리1,33,59,31,28,2025-07-31
2016,동복면,연둔리1,34,51,22,29,2025-07-31
2016,동복면,연둔리2,20,31,12,19,2025-07-31
2016,동복면,구암리1,32,71,34,37,2025-07-31
2016,동복면,구암리2,27,51,22,29,2025-07-31
2016,동복면,한천리1,109,173,75,98,2025-07-31
2016,사평면,사평리1,54,101,47,54,2025-07-31
2016,사평면,사평리2,67,126,60,66,2025-07-31
2016,사평면,사평리3,55,115,60,55,2025-07-31
2016,사평면,사평리4,57,121,62,59,2025-07-31
2016,사평면,사평리5,74,123,59,64,2025-07-31
2016,사평면,대곡리1,44,90,45,45,2025-07-31
2016,사평면,대곡리2,25,42,24,18,2025-07-31
2016,사평면,검산리1,41,78,44,34,2025-07-31
2016,사평면,검산리2,18,32,18,14,2025-07-31
2016,사평면,운산리1,30,49,24,25,2025-07-31
2016,사평면,원리1,55,98,43,55,2025-07-31
2016,사평면,원리2,36,68,33,35,2025-07-31
2016,사평면,벽송리1,110,204,101,103,2025-07-31
2016,사평면,벽송리2,28,54,28,26,2025-07-31
2016,사평면,장전리1,53,98,45,53,2025-07-31
2016,사평면,장전리2,34,67,38,29,2025-07-31
2016,사평면,절산리1,71,131,60,71,2025-07-31
2016,사평면,절산리2,44,75,32,43,2025-07-31
2016,사평면,사수리1,26,45,22,23,2025-07-31
2016,사평면,사수리2,27,37,20,17,2025-07-31
2016,사평면,주산리1,27,51,27,24,2025-07-31
2016,사평면,복교리1,10,20,11,9,2025-07-31
2016,사평면,남계리1,59,89,39,50,2025-07-31
2016,사평면,유마리1,25,46,19,27,2025-07-31
2016,사평면,다산리1,60,97,48,49,2025-07-31
2016,사평면,용리1,21,33,15,18,2025-07-31
2016,사평면,용리2,47,80,40,40,2025-07-31
2016,사평면,내리1,30,49,23,26,2025-07-31
2016,사평면,내리2,28,45,22,23,2025-07-31
2016,사평면,내리3,35,62,35,27,2025-07-31
2016,동면,백용리1,38,89,40,49,2025-07-31
2016,동면,백용리2,81,157,82,75,2025-07-31
2016,동면,언도리1,51,93,47,46,2025-07-31
2016,동면,언도리2,57,120,61,59,2025-07-31
2016,동면,서성리1,33,68,34,34,2025-07-31
2016,동면,서성리2,31,68,33,35,2025-07-31
2016,동면,국동리1,45,69,35,34,2025-07-31
2016,동면,청궁리2,78,140,64,76,2025-07-31
2016,동면,마산리1,44,110,66,44,2025-07-31
2016,동면,무포리1,31,61,33,28,2025-07-31
2016,동면,무포리2,20,44,25,19,2025-07-31
2016,동면,경치리1,46,78,31,47,2025-07-31
2016,동면,경치리2,16,26,12,14,2025-07-31
2016,동면,복암리1,65,100,44,56,2025-07-31
2016,동면,복암리2,146,245,143,102,2025-07-31
2016,동면,복암리3,41,63,28,35,2025-07-31
2016,동면,오동리1,141,280,144,136,2025-07-31
2016,동면,오동리2,31,55,27,28,2025-07-31
2016,동면,오동리3,51,108,52,56,2025-07-31
2016,동면,천덕리1,50,95,60,35,2025-07-31
2016,동면,천덕리2,43,90,49,41,2025-07-31
2016,동면,천덕리3,79,177,81,96,2025-07-31
2016,동면,장동리1,156,290,142,148,2025-07-31
2016,동면,장동리2,85,168,77,91,2025-07-31
2016,동면,운농리1,83,148,78,70,2025-07-31
2016,동면,운농리2,71,122,72,50,2025-07-31
2016,동면,운농리3,65,127,66,61,2025-07-31
2016,동면,옥호리1,39,68,37,31,2025-07-31
2016,동면,옥호리2,29,46,23,23,2025-07-31
2016,동면,옥호리3,18,34,17,17,2025-07-31
2016,동면,대포리1,58,103,50,53,2025-07-31
2016,동면,대포리2,37,60,28,32,2025-07-31
2016,동면,대포리3,64,120,66,54,2025-07-31
2017,화순읍,교리1,276,580,302,278,2025-07-31
2017,화순읍,교리2,540,1574,793,781,2025-07-31
2017,화순읍,교리3,179,387,185,202,2025-07-31
2017,화순읍,향청리,230,485,248,237,2025-07-31
2017,화순읍,만연1리,109,248,134,114,2025-07-31
2017,화순읍,만연2리,113,256,139,117,2025-07-31
2017,화순읍,만연3리,840,1980,931,1049,2025-07-31
2017,화순읍,만연4리,505,1488,699,789,2025-07-31
2017,화순읍,만연5리,1034,2352,1070,1282,2025-07-31
2017,화순읍,만연6리,819,2028,932,1096,2025-07-31
2017,화순읍,신기1리,370,773,419,354,2025-07-31
2017,화순읍,신기2리,1269,3393,1670,1723,2025-07-31
2017,화순읍,신기3리,275,629,321,308,2025-07-31
2017,화순읍,훈리,180,414,209,205,2025-07-31
2017,화순읍,동구리,30,55,31,24,2025-07-31
2017,화순읍,유천1리,63,154,84,70,2025-07-31
2017,화순읍,유천2리,42,81,43,38,2025-07-31
2017,화순읍,유천3리,33,78,38,40,2025-07-31
2017,화순읍,일심1리,222,503,262,241,2025-07-31
2017,화순읍,일심2리,42,93,48,45,2025-07-31
2017,화순읍,일심3리,47,98,50,48,2025-07-31
2017,화순읍,일심4리,371,929,449,480,2025-07-31
2017,화순읍,일심5리,554,1322,671,651,2025-07-31
2017,화순읍,일심6리,636,1905,914,991,2025-07-31
2017,화순읍,다지1리,83,243,119,124,2025-07-31
2017,화순읍,다지2리,85,142,76,66,2025-07-31
2017,화순읍,광덕1리,244,560,267,293,2025-07-31
2017,화순읍,광덕2리,172,428,200,228,2025-07-31
2017,화순읍,광덕3리,64,146,80,66,2025-07-31
2017,화순읍,광덕4리,518,1535,767,768,2025-07-31
2017,화순읍,광덕5리,439,1307,629,678,2025-07-31
2017,화순읍,삼천1리,106,221,107,114,2025-07-31
2017,화순읍,삼천2리,430,1356,663,693,2025-07-31
2017,화순읍,삼천3리,41,82,41,41,2025-07-31
2017,화순읍,삼천4리,440,753,380,373,2025-07-31
2017,화순읍,이십곡1리,76,152,79,73,2025-07-31
2017,화순읍,이십곡2리,33,64,32,32,2025-07-31
2017,화순읍,대리1리,364,858,434,424,2025-07-31
2017,화순읍,대리2리,60,122,62,60,2025-07-31
2017,화순읍,대리3리,57,148,78,70,2025-07-31
2017,화순읍,대리4리,80,181,86,95,2025-07-31
2017,화순읍,대리5리,403,947,440,507,2025-07-31
2017,화순읍,대리6리,376,1181,566,615,2025-07-31
2017,화순읍,대리7리,384,675,327,348,2025-07-31
2017,화순읍,강정리,356,1153,544,609,2025-07-31
2017,화순읍,벽라1리,551,1678,832,846,2025-07-31
2017,화순읍,벽라2리,5,13,8,5,2025-07-31
2017,화순읍,벽라3리,87,194,93,101,2025-07-31
2017,화순읍,감도1리,126,243,126,117,2025-07-31
2017,화순읍,감도2리,377,995,481,514,2025-07-31
2017,화순읍,감도3리,21,46,19,27,2025-07-31
2017,화순읍,계소1리,158,401,200,201,2025-07-31
2017,화순읍,계소2리,21,46,25,21,2025-07-31
2017,화순읍,계소3리,47,95,52,43,2025-07-31
2017,화순읍,계소4리,252,554,273,281,2025-07-31
2017,화순읍,도웅1리,82,148,78,70,2025-07-31
2017,화순읍,도웅2리,23,38,17,21,2025-07-31
2017,화순읍,세량리,41,80,39,41,2025-07-31
2017,화순읍,연양1리,48,90,41,49,2025-07-31
2017,화순읍,연양2리,88,160,89,71,2025-07-31
2017,화순읍,내평리,110,215,110,105,2025-07-31
2017,화순읍,서태1리,84,167,81,86,2025-07-31
2017,화순읍,서태2리,44,78,38,40,2025-07-31
2017,화순읍,앵남1리,57,102,53,49,2025-07-31
2017,화순읍,앵남2리,47,74,38,36,2025-07-31
2017,화순읍,수만1리,28,47,27,20,2025-07-31
2017,화순읍,수만2리,21,29,19,10,2025-07-31
2017,화순읍,수만3리,58,114,63,51,2025-07-31
2017,화순읍,주도1리,37,70,40,30,2025-07-31
2017,화순읍,주도2리,56,106,50,56,2025-07-31
2017,화순읍,주도3리,54,103,49,54,2025-07-31
2017,한천면,모산1리,96,172,92,80,2025-07-31
2017,한천면,모산2리,28,49,29,20,2025-07-31
2017,한천면,금전리,49,86,47,39,2025-07-31
2017,한천면,한계1리,94,168,81,87,2025-07-31
2017,한천면,한계2리,55,110,51,59,2025-07-31
2017,한천면,정1리,25,41,27,14,2025-07-31
2017,한천면,정2리,29,61,30,31,2025-07-31
2017,한천면,가암1리,27,58,32,26,2025-07-31
2017,한천면,가암2리,38,54,22,32,2025-07-31
2017,한천면,오음1리,38,68,32,36,2025-07-31
2017,한천면,오음2리,24,51,27,24,2025-07-31
2017,한천면,오음3리,25,38,22,16,2025-07-31
2017,한천면,반곡1리,30,61,27,34,2025-07-31
2017,한천면,반곡2리,37,56,30,26,2025-07-31
2017,한천면,평리,50,86,40,46,2025-07-31
2017,한천면,정우리,41,64,27,37,2025-07-31
2017,한천면,동가1리,67,110,55,55,2025-07-31
2017,한천면,동가2리,31,63,31,32,2025-07-31
2017,한천면,고시리,8,17,13,4,2025-07-31
2017,춘양면,석정리,215,409,212,197,2025-07-31
2017,춘양면,화림1리,27,45,22,23,2025-07-31
2017,춘양면,화림2리,57,95,48,47,2025-07-31
2017,춘양면,화림3리,34,75,32,43,2025-07-31
2017,춘양면,대신1리,37,67,39,28,2025-07-31
2017,춘양면,대신2리,24,40,21,19,2025-07-31
2017,춘양면,대신3리,38,62,34,28,2025-07-31
2017,춘양면,회송1리,34,52,22,30,2025-07-31
2017,춘양면,회송2리,34,62,39,23,2025-07-31
2017,춘양면,양곡리,51,92,50,42,2025-07-31
2017,춘양면,용곡리,56,100,54,46,2025-07-31
2017,춘양면,월평1리,32,68,33,35,2025-07-31
2017,춘양면,월평2리,21,38,17,21,2025-07-31
2017,춘양면,월평3리,17,31,17,14,2025-07-31
2017,춘양면,변천리,48,81,40,41,2025-07-31
2017,춘양면,가동리,9,11,5,6,2025-07-31
2017,춘양면,산간리,60,101,42,59,2025-07-31
2017,춘양면,가봉리,78,139,71,68,2025-07-31
2017,춘양면,용두리,42,64,29,35,2025-07-31
2017,춘양면,우봉리,82,192,100,92,2025-07-31
2017,춘양면,부곡1리,28,47,20,27,2025-07-31
2017,춘양면,부곡2리,22,36,13,23,2025-07-31
2017,춘양면,부곡3리,24,44,22,22,2025-07-31
2017,청풍면,풍암리,73,129,61,68,2025-07-31
2017,청풍면,한지1리,39,58,24,34,2025-07-31
2017,청풍면,한지2리,27,47,20,27,2025-07-31
2017,청풍면,어리,45,69,35,34,2025-07-31
2017,청풍면,세청1리,59,97,46,51,2025-07-31
2017,청풍면,세청2리,20,26,11,15,2025-07-31
2017,청풍면,대비리,43,65,28,37,2025-07-31
2017,청풍면,백운리,46,80,35,45,2025-07-31
2017,청풍면,청용리,38,56,28,28,2025-07-31
2017,청풍면,이만리,17,27,14,13,2025-07-31
2017,청풍면,신석1리,24,33,16,17,2025-07-31
2017,청풍면,신석2리,21,41,22,19,2025-07-31
2017,청풍면,신1리,43,75,34,41,2025-07-31
2017,청풍면,신2리,36,60,28,32,2025-07-31
2017,청풍면,차1리,26,44,19,25,2025-07-31
2017,청풍면,차2리,110,189,94,95,2025-07-31
2017,이양면,금능리,88,181,84,97,2025-07-31
2017,이양면,강성1리,40,58,25,33,2025-07-31
2017,이양면,강성2리,33,56,27,29,2025-07-31
2017,이양면,강성3리,28,49,25,24,2025-07-31
2017,이양면,용반리,34,46,19,27,2025-07-31
2017,이양면,장치리,18,23,11,12,2025-07-31
2017,이양면,묵곡1리,27,49,27,22,2025-07-31
2017,이양면,묵곡2리,25,52,25,27,2025-07-31
2017,이양면,옥리,19,37,21,16,2025-07-31
2017,이양면,품평1리,52,70,32,38,2025-07-31
2017,이양면,품평2리,33,83,38,45,2025-07-31
2017,이양면,품평3리,41,78,36,42,2025-07-31
2017,이양면,오류1리,89,168,84,84,2025-07-31
2017,이양면,오류2리,38,65,30,35,2025-07-31
2017,이양면,오류3리,41,85,42,43,2025-07-31
2017,이양면,오류4리,25,40,21,19,2025-07-31
2017,이양면,이양1리,48,77,36,41,2025-07-31
2017,이양면,이양2리,60,110,51,59,2025-07-31
2017,이양면,율계리,49,79,38,41,2025-07-31
2017,이양면,송정1리,23,34,15,19,2025-07-31
2017,이양면,송정2리,22,42,22,20,2025-07-31
2017,이양면,초방1리,31,46,21,25,2025-07-31
2017,이양면,초방2리,28,47,23,24,2025-07-31
2017,이양면,매정1리,24,39,21,18,2025-07-31
2017,이양면,매정2리,32,70,34,36,2025-07-31
2017,이양면,연화리,29,42,27,15,2025-07-31
2017,이양면,구례리,34,59,26,33,2025-07-31
2017,이양면,쌍봉리,68,117,57,60,2025-07-31
2017,이양면,증리,33,52,25,27,2025-07-31
2017,능주면,남정1리,130,271,144,127,2025-07-31
2017,능주면,남정2리,32,52,20,32,2025-07-31
2017,능주면,정남리,75,158,72,86,2025-07-31
2017,능주면,석고리,195,371,179,192,2025-07-31
2017,능주면,잠정1리,152,341,162,179,2025-07-31
2017,능주면,잠정2리,246,639,320,319,2025-07-31
2017,능주면,내리,27,47,26,21,2025-07-31
2017,능주면,관영리,259,522,251,271,2025-07-31
2017,능주면,천덕1리,62,103,53,50,2025-07-31
2017,능주면,천덕2리,48,85,38,47,2025-07-31
2017,능주면,만인리,70,144,78,66,2025-07-31
2017,능주면,광사리,51,90,52,38,2025-07-31
2017,능주면,백암1리,103,173,92,81,2025-07-31
2017,능주면,백암2리,41,90,41,49,2025-07-31
2017,능주면,만수1리,59,139,65,74,2025-07-31
2017,능주면,만수2리,44,90,45,45,2025-07-31
2017,능주면,원지리,95,170,81,89,2025-07-31
2017,도곡면,대곡1리,42,92,44,48,2025-07-31
2017,도곡면,대곡2리,53,97,51,46,2025-07-31
2017,도곡면,대곡3리,70,130,65,65,2025-07-31
2017,도곡면,효산1리,153,289,145,144,2025-07-31
2017,도곡면,효산2리,74,132,62,70,2025-07-31
2017,도곡면,월곡1리,38,75,39,36,2025-07-31
2017,도곡면,월곡2리,45,78,30,48,2025-07-31
2017,도곡면,월곡3리,43,78,43,35,2025-07-31
2017,도곡면,쌍옥1리,73,144,63,81,2025-07-31
2017,도곡면,쌍옥2리,58,103,46,57,2025-07-31
2017,도곡면,평리,85,160,78,82,2025-07-31
2017,도곡면,덕곡1리,40,56,25,31,2025-07-31
2017,도곡면,덕곡2리,31,65,34,31,2025-07-31
2017,도곡면,신성1리,57,103,53,50,2025-07-31
2017,도곡면,신성2리,40,82,40,42,2025-07-31
2017,도곡면,천암리,234,483,240,243,2025-07-31
2017,도곡면,원화1리,82,147,75,72,2025-07-31
2017,도곡면,원화2리,49,87,47,40,2025-07-31
2017,도곡면,신덕1리,49,97,52,45,2025-07-31
2017,도곡면,신덕2리,43,72,32,40,2025-07-31
2017,도곡면,신덕3리,41,72,34,38,2025-07-31
2017,도곡면,미곡1리,32,63,33,30,2025-07-31
2017,도곡면,미곡2리,47,83,41,42,2025-07-31
2017,도곡면,죽청1리,71,146,77,69,2025-07-31
2017,도곡면,죽청2리,28,39,17,22,2025-07-31
2017,도암면,운월1리,40,64,30,34,2025-07-31
2017,도암면,운월2리,28,52,28,24,2025-07-31
2017,도암면,도장리,62,123,58,65,2025-07-31
2017,도암면,벽지1리,27,44,20,24,2025-07-31
2017,도암면,벽지2리,20,47,30,17,2025-07-31
2017,도암면,정천리,79,129,68,61,2025-07-31
2017,도암면,원천1리,55,93,48,45,2025-07-31
2017,도암면,원천2리,23,46,24,22,2025-07-31
2017,도암면,원천3리,56,98,44,54,2025-07-31
2017,도암면,천태1리,37,72,38,34,2025-07-31
2017,도암면,천태2리,49,76,34,42,2025-07-31
2017,도암면,지월1리,17,37,23,14,2025-07-31
2017,도암면,지월2리,36,61,29,32,2025-07-31
2017,도암면,지월3리,15,29,12,17,2025-07-31
2017,도암면,등광리,53,86,47,39,2025-07-31
2017,도암면,대초리,32,53,30,23,2025-07-31
2017,도암면,용강1리,46,68,35,33,2025-07-31
2017,도암면,용강2리,28,45,20,25,2025-07-31
2017,도암면,용강3리,38,73,40,33,2025-07-31
2017,도암면,호암1리,24,36,19,17,2025-07-31
2017,도암면,호암2리,22,38,17,21,2025-07-31
2017,도암면,우치리,30,40,20,20,2025-07-31
2017,도암면,봉하리,25,43,26,17,2025-07-31
2017,도암면,왕정리,8,13,9,4,2025-07-31
2017,도암면,행산리,11,19,10,9,2025-07-31
2017,이서면,서리,17,20,13,7,2025-07-31
2017,이서면,월산리,4,6,4,2,2025-07-31
2017,이서면,창량리,29,43,22,21,2025-07-31
2017,이서면,도석리,3,11,6,5,2025-07-31
2017,이서면,야사1리,58,103,51,52,2025-07-31
2017,이서면,야사2리,61,106,51,55,2025-07-31
2017,이서면,야사3리,19,35,17,18,2025-07-31
2017,이서면,야사4리,26,45,21,24,2025-07-31
2017,이서면,보월1리,62,107,54,53,2025-07-31
2017,이서면,보월2리,25,33,15,18,2025-07-31
2017,이서면,인계1리,25,39,23,16,2025-07-31
2017,이서면,인계2리,39,78,43,35,2025-07-31
2017,이서면,인계3리,22,36,17,19,2025-07-31
2017,이서면,영평1리,69,122,57,65,2025-07-31
2017,이서면,영평2리,19,29,17,12,2025-07-31
2017,이서면,안심1리,60,109,53,56,2025-07-31
2017,이서면,안심2리,20,38,24,14,2025-07-31
2017,이서면,갈두리,6,15,9,6,2025-07-31
2017,백아면,임곡리,56,107,53,54,2025-07-31
2017,백아면,옥1리,56,106,50,56,2025-07-31
2017,백아면,옥2리,28,47,26,21,2025-07-31
2017,백아면,서유1리,58,101,50,51,2025-07-31
2017,백아면,서유2리,25,39,21,18,2025-07-31
2017,백아면,맹리,37,54,32,22,2025-07-31
2017,백아면,남치리,46,90,39,51,2025-07-31
2017,백아면,원리,107,198,96,102,2025-07-31
2017,백아면,송단1리,31,51,26,25,2025-07-31
2017,백아면,송단2리,48,78,43,35,2025-07-31
2017,백아면,방리,28,50,28,22,2025-07-31
2017,백아면,노기리,33,57,28,29,2025-07-31
2017,백아면,이천1리,49,95,49,46,2025-07-31
2017,백아면,이천2리,71,111,57,54,2025-07-31
2017,백아면,길성리,50,74,33,41,2025-07-31
2017,백아면,와천리,18,30,16,14,2025-07-31
2017,백아면,다곡리,60,91,44,47,2025-07-31
2017,백아면,수리,87,151,71,80,2025-07-31
2017,백아면,노치리,21,53,29,24,2025-07-31
2017,백아면,용곡1리,44,66,32,34,2025-07-31
2017,백아면,용곡2리,19,25,11,14,2025-07-31
2017,동복면,독상리,123,220,99,121,2025-07-31
2017,동복면,칠정1리,48,86,48,38,2025-07-31
2017,동복면,칠정2리,33,55,25,30,2025-07-31
2017,동복면,천변리,91,190,85,105,2025-07-31
2017,동복면,유천리,82,134,64,70,2025-07-31
2017,동복면,신율1리,38,68,35,33,2025-07-31
2017,동복면,신율2리,25,45,25,20,2025-07-31
2017,동복면,신율3리,32,58,27,31,2025-07-31
2017,동복면,가수1리,40,78,39,39,2025-07-31
2017,동복면,가수2리,19,38,18,20,2025-07-31
2017,동복면,가수3리,19,29,15,14,2025-07-31
2017,동복면,안성1리,22,43,23,20,2025-07-31
2017,동복면,안성2리,39,57,30,27,2025-07-31
2017,동복면,연월1리,43,67,26,41,2025-07-31
2017,동복면,연월2리,36,65,28,37,2025-07-31
2017,동복면,연월3리,34,56,30,26,2025-07-31
2017,동복면,읍애리,38,70,40,30,2025-07-31
2017,동복면,연둔1리,34,48,21,27,2025-07-31
2017,동복면,연둔2리,22,37,15,22,2025-07-31
2017,동복면,구암1리,34,73,36,37,2025-07-31
2017,동복면,구암2리,26,50,22,28,2025-07-31
2017,동복면,한천리,100,163,73,90,2025-07-31
2017,사평면,사평1리,51,90,43,47,2025-07-31
2017,사평면,사평2리,62,117,59,58,2025-07-31
2017,사평면,사평3리,52,119,61,58,2025-07-31
2017,사평면,사평4리,55,105,50,55,2025-07-31
2017,사평면,사평5리,74,130,61,69,2025-07-31
2017,사평면,대곡1리,43,87,44,43,2025-07-31
2017,사평면,대곡2리,25,38,19,19,2025-07-31
2017,사평면,검산1리,38,74,41,33,2025-07-31
2017,사평면,검산2리,15,23,12,11,2025-07-31
2017,사평면,운산리,29,47,23,24,2025-07-31
2017,사평면,원1리,57,103,51,52,2025-07-31
2017,사평면,원2리,34,66,34,32,2025-07-31
2017,사평면,벽송1리,109,206,96,110,2025-07-31
2017,사평면,벽송2리,28,54,29,25,2025-07-31
2017,사평면,장전1리,52,103,48,55,2025-07-31
2017,사평면,장전2리,37,73,42,31,2025-07-31
2017,사평면,절산1리,70,122,59,63,2025-07-31
2017,사평면,절산2리,41,71,31,40,2025-07-31
2017,사평면,사수1리,23,36,18,18,2025-07-31
2017,사평면,사수2리,25,32,15,17,2025-07-31
2017,사평면,주산리,29,53,27,26,2025-07-31
2017,사평면,복교리,8,19,11,8,2025-07-31
2017,사평면,남계리,58,91,42,49,2025-07-31
2017,사평면,유마리,26,49,21,28,2025-07-31
2017,사평면,다산리,59,100,52,48,2025-07-31
2017,사평면,용1리,22,31,13,18,2025-07-31
2017,사평면,용2리,43,70,35,35,2025-07-31
2017,사평면,내1리,27,47,23,24,2025-07-31
2017,사평면,내2리,30,46,22,24,2025-07-31
2017,사평면,내3리,33,58,33,25,2025-07-31
2017,동면,백용1리,39,87,37,50,2025-07-31
2017,동면,백용2리,76,150,80,70,2025-07-31
2017,동면,언도1리,51,93,44,49,2025-07-31
2017,동면,언도2리,59,118,57,61,2025-07-31
2017,동면,서성1리,32,58,27,31,2025-07-31
2017,동면,서성2리,33,67,34,33,2025-07-31
2017,동면,국동리,43,66,35,31,2025-07-31
2017,동면,청궁리,81,134,65,69,2025-07-31
2017,동면,마산리,45,118,66,52,2025-07-31
2017,동면,무포1리,32,56,31,25,2025-07-31
2017,동면,무포2리,19,44,26,18,2025-07-31
2017,동면,경치1리,44,72,31,41,2025-07-31
2017,동면,경치2리,16,30,12,18,2025-07-31
2017,동면,복암1리,60,91,42,49,2025-07-31
2017,동면,복암2리,139,235,135,100,2025-07-31
2017,동면,복암3리,42,65,30,35,2025-07-31
2017,동면,오동1리,136,248,129,119,2025-07-31
2017,동면,오동2리,30,55,30,25,2025-07-31
2017,동면,오동3리,54,113,56,57,2025-07-31
2017,동면,천덕1리,53,96,59,37,2025-07-31
2017,동면,천덕2리,39,82,45,37,2025-07-31
2017,동면,천덕3리,79,177,85,92,2025-07-31
2017,동면,장동1리,155,275,128,147,2025-07-31
2017,동면,장동2리,92,166,75,91,2025-07-31
2017,동면,운농1리,82,140,78,62,2025-07-31
2017,동면,운농2리,68,116,69,47,2025-07-31
2017,동면,운농3리,59,117,62,55,2025-07-31
2017,동면,옥호1리,40,69,36,33,2025-07-31
2017,동면,옥호2리,29,45,21,24,2025-07-31
2017,동면,옥호3리,16,31,15,16,2025-07-31
2017,동면,대포1리,58,101,47,54,2025-07-31
2017,동면,대포2리,35,57,27,30,2025-07-31
2017,동면,대포3리,66,118,62,56,2025-07-31
2018,화순읍,교리1,292,594,319,275,2025-07-31
2018,화순읍,교리2,540,1551,781,770,2025-07-31
2018,화순읍,교리3,163,343,186,175,2025-07-31
2018,화순읍,향청리,240,483,249,234,2025-07-31
2018,화순읍,만연1리,106,233,121,112,2025-07-31
2018,화순읍,만연2리,114,259,144,115,2025-07-31
2018,화순읍,만연3리,817,1875,888,987,2025-07-31
2018,화순읍,만연4리,510,1465,694,771,2025-07-31
2018,화순읍,만연5리,1038,2325,1063,1262,2025-07-31
2018,화순읍,만연6리,855,2022,930,1092,2025-07-31
2018,화순읍,신기1리,373,756,411,345,2025-07-31
2018,화순읍,신기2리,1285,3319,1647,1672,2025-07-31
2018,화순읍,신기3리,279,623,323,300,2025-07-31
2018,화순읍,훈리,196,426,224,202,2025-07-31
2018,화순읍,동구리,32,54,33,21,2025-07-31
2018,화순읍,유천1리,70,172,91,81,2025-07-31
2018,화순읍,유천2리,41,76,38,38,2025-07-31
2018,화순읍,유천3리,33,79,34,45,2025-07-31
2018,화순읍,일심1리,230,474,248,226,2025-07-31
2018,화순읍,일심2리,39,84,43,42,2025-07-31
2018,화순읍,일심3리,49,99,48,51,2025-07-31
2018,화순읍,일심4리,383,929,448,481,2025-07-31
2018,화순읍,일심5리,554,1298,653,645,2025-07-31
2018,화순읍,일심6리,645,1882,916,966,2025-07-31
2018,화순읍,다지1리,92,242,120,122,2025-07-31
2018,화순읍,다지2리,89,150,80,70,2025-07-31
2018,화순읍,광덕1리,239,545,256,289,2025-07-31
2018,화순읍,광덕2리,163,387,185,202,2025-07-31
2018,화순읍,광덕3리,73,154,80,74,2025-07-31
2018,화순읍,광덕4리,535,1542,768,774,2025-07-31
2018,화순읍,광덕5리,440,1273,603,670,2025-07-31
2018,화순읍,삼천1리,112,217,106,111,2025-07-31
2018,화순읍,삼천2리,444,1393,680,713,2025-07-31
2018,화순읍,삼천3리,53,98,44,54,2025-07-31
2018,화순읍,삼천4리,448,749,381,368,2025-07-31
2018,화순읍,이십곡1리,69,139,68,71,2025-07-31
2018,화순읍,이십곡2리,34,67,32,35,2025-07-31
2018,화순읍,대리1리,360,840,423,417,2025-07-31
2018,화순읍,대리2리,61,125,59,66,2025-07-31
2018,화순읍,대리3리,56,136,69,67,2025-07-31
2018,화순읍,대리4리,81,169,81,88,2025-07-31
2018,화순읍,대리5리,409,929,441,488,2025-07-31
2018,화순읍,대리6리,376,1162,550,612,2025-07-31
2018,화순읍,대리7리,398,692,331,361,2025-07-31
2018,화순읍,대리8리,353,1169,552,617,2025-07-31
2018,화순읍,대리9리,558,1708,843,865,2025-07-31
2018,화순읍,강정리,6,13,8,5,2025-07-31
2018,화순읍,벽라1리,91,190,91,99,2025-07-31
2018,화순읍,벽라2리,120,230,120,110,2025-07-31
2018,화순읍,벽라3리,390,1022,502,520,2025-07-31
2018,화순읍,감도1리,68,146,78,68,2025-07-31
2018,화순읍,감도2리,52,107,52,55,2025-07-31
2018,화순읍,감도3리,22,44,20,24,2025-07-31
2018,화순읍,계소1리,163,384,189,195,2025-07-31
2018,화순읍,계소2리,21,46,23,23,2025-07-31
2018,화순읍,계소3리,41,83,46,37,2025-07-31
2018,화순읍,계소4리,250,546,264,282,2025-07-31
2018,화순읍,도웅1리,83,148,77,71,2025-07-31
2018,화순읍,도웅2리,24,39,15,24,2025-07-31
2018,화순읍,세량리,50,88,48,40,2025-07-31
2018,화순읍,연양1리,48,82,39,43,2025-07-31
2018,화순읍,연양2리,85,159,87,72,2025-07-31
2018,화순읍,내평리,110,210,102,108,2025-07-31
2018,화순읍,서태1리,87,166,80,86,2025-07-31
2018,화순읍,서태2리,45,91,44,47,2025-07-31
2018,화순읍,앵남1리,61,102,54,48,2025-07-31
2018,화순읍,앵남2리,48,72,37,35,2025-07-31
2018,화순읍,수만1리,32,48,27,21,2025-07-31
2018,화순읍,수만2리,26,37,24,13,2025-07-31
2018,화순읍,수만3리,61,120,66,54,2025-07-31
2018,화순읍,주도1리,37,64,38,26,2025-07-31
2018,화순읍,주도2리,56,116,56,60,2025-07-31
2018,화순읍,주도3리,54,97,43,54,2025-07-31
2018,한천면,모산1리,96,172,92,80,2025-07-31
2018,한천면,모산2리,28,49,29,20,2025-07-31
2018,한천면,금전리,49,86,47,39,2025-07-31
2018,한천면,한계1리,94,168,81,87,2025-07-31
2018,한천면,한계2리,55,110,51,59,2025-07-31
2018,한천면,정1리,25,41,27,14,2025-07-31
2018,한천면,정2리,29,61,30,31,2025-07-31
2018,한천면,가암1리,27,58,32,26,2025-07-31
2018,한천면,가암2리,38,54,22,32,2025-07-31
2018,한천면,오음1리,38,68,32,36,2025-07-31
2018,한천면,오음2리,24,51,27,24,2025-07-31
2018,한천면,오음3리,25,38,22,16,2025-07-31
2018,한천면,반곡1리,30,61,27,34,2025-07-31
2018,한천면,반곡2리,37,56,30,26,2025-07-31
2018,한천면,평리,50,86,40,46,2025-07-31
2018,한천면,정우리,41,64,27,37,2025-07-31
2018,한천면,동가1리,67,110,55,55,2025-07-31
2018,한천면,동가2리,31,63,31,32,2025-07-31
2018,한천면,고시리,8,17,13,4,2025-07-31
2018,춘양면,석정리,226,412,216,196,2025-07-31
2018,춘양면,화림1리,27,44,22,22,2025-07-31
2018,춘양면,화림2리,55,96,47,49,2025-07-31
2018,춘양면,화림3리,38,82,38,44,2025-07-31
2018,춘양면,대신1리,37,62,35,27,2025-07-31
2018,춘양면,대신2리,26,43,23,20,2025-07-31
2018,춘양면,대신3리,36,57,30,27,2025-07-31
2018,춘양면,회송1리,30,47,19,28,2025-07-31
2018,춘양면,회송2리,35,65,41,24,2025-07-31
2018,춘양면,양곡리,54,97,53,44,2025-07-31
2018,춘양면,용곡리,56,95,50,45,2025-07-31
2018,춘양면,월평1리,34,72,36,36,2025-07-31
2018,춘양면,월평2리,21,34,15,19,2025-07-31
2018,춘양면,월평3리,17,29,14,15,2025-07-31
2018,춘양면,변천리,46,69,35,34,2025-07-31
2018,춘양면,가동리,9,13,8,5,2025-07-31
2018,춘양면,산간리,60,101,43,58,2025-07-31
2018,춘양면,가봉리,74,123,62,61,2025-07-31
2018,춘양면,용두리,43,64,31,33,2025-07-31
2018,춘양면,우봉리,81,179,92,87,2025-07-31
2018,춘양면,부곡1리,28,48,19,29,2025-07-31
2018,춘양면,부곡2리,25,44,17,27,2025-07-31
2018,춘양면,부곡3리,25,43,22,21,2025-07-31
2018,청풍면,풍암리,72,128,57,71,2025-07-31
2018,청풍면,한지1리,37,57,25,32,2025-07-31
2018,청풍면,한지2리,28,47,20,27,2025-07-31
2018,청풍면,어리,46,75,37,38,2025-07-31
2018,청풍면,세청1리,56,99,48,51,2025-07-31
2018,청풍면,세청2리,19,28,14,14,2025-07-31
2018,청풍면,대비리,43,66,29,37,2025-07-31
2018,청풍면,백운리,46,80,37,43,2025-07-31
2018,청풍면,청용리,35,52,27,25,2025-07-31
2018,청풍면,이만리,17,27,14,13,2025-07-31
2018,청풍면,신석1리,24,33,15,18,2025-07-31
2018,청풍면,신석2리,19,41,19,22,2025-07-31
2018,청풍면,신1리,41,72,35,37,2025-07-31
2018,청풍면,신2리,35,57,27,30,2025-07-31
2018,청풍면,차1리,25,38,14,24,2025-07-31
2018,청풍면,차2리,103,172,85,87,2025-07-31
2018,이양면,금능리,92,180,86,94,2025-07-31
2018,이양면,강성1리,39,52,22,30,2025-07-31
2018,이양면,강성2리,35,56,26,30,2025-07-31
2018,이양면,강성3리,27,46,24,22,2025-07-31
2018,이양면,용반리,32,42,17,25,2025-07-31
2018,이양면,장치리,20,28,15,13,2025-07-31
2018,이양면,묵곡1리,21,41,21,20,2025-07-31
2018,이양면,묵곡2리,25,48,22,26,2025-07-31
2018,이양면,옥리,17,35,19,16,2025-07-31
2018,이양면,품평1리,54,72,33,39,2025-07-31
2018,이양면,품평2리,35,80,37,43,2025-07-31
2018,이양면,품평3리,41,76,36,40,2025-07-31
2018,이양면,오류1리,90,147,70,77,2025-07-31
2018,이양면,오류2리,40,65,34,31,2025-07-31
2018,이양면,오류3리,43,95,46,49,2025-07-31
2018,이양면,오류4리,22,37,19,18,2025-07-31
2018,이양면,이양1리,49,73,36,37,2025-07-31
2018,이양면,이양2리,66,114,50,64,2025-07-31
2018,이양면,율계리,46,78,37,41,2025-07-31
2018,이양면,송정1리,24,33,12,21,2025-07-31
2018,이양면,송정2리,23,43,24,19,2025-07-31
2018,이양면,초방1리,28,44,22,22,2025-07-31
2018,이양면,초방2리,27,40,22,18,2025-07-31
2018,이양면,매정1리,24,36,19,17,2025-07-31
2018,이양면,매정2리,32,71,33,38,2025-07-31
2018,이양면,연화리,30,42,26,16,2025-07-31
2018,이양면,구례리,35,59,25,34,2025-07-31
2018,이양면,쌍봉리,68,110,51,59,2025-07-31
2018,이양면,증리,29,47,28,19,2025-07-31
2018,능주면,남정1리,122,262,144,118,2025-07-31
2018,능주면,남정2리,33,51,21,30,2025-07-31
2018,능주면,정남리,75,148,65,83,2025-07-31
2018,능주면,석고리,189,362,175,187,2025-07-31
2018,능주면,잠정1리,148,312,152,160,2025-07-31
2018,능주면,잠정2리,244,625,320,305,2025-07-31
2018,능주면,내리,27,48,28,20,2025-07-31
2018,능주면,관영리,255,505,423,262,2025-07-31
2018,능주면,천덕1리,63,107,56,51,2025-07-31
2018,능주면,천덕2리,45,80,34,46,2025-07-31
2018,능주면,만인리,67,147,80,67,2025-07-31
2018,능주면,광사리,49,88,48,40,2025-07-31
2018,능주면,백암1리,97,173,91,82,2025-07-31
2018,능주면,백암2리,45,93,45,48,2025-07-31
2018,능주면,만수1리,55,128,62,66,2025-07-31
2018,능주면,만수2리,48,101,49,52,2025-07-31
2018,능주면,원지리,97,167,81,86,2025-07-31
2018,도곡면,대곡1리,45,86,41,45,2025-07-31
2018,도곡면,대곡2리,53,97,49,48,2025-07-31
2018,도곡면,대곡3리,67,114,56,58,2025-07-31
2018,도곡면,효산1리,154,297,149,148,2025-07-31
2018,도곡면,효산2리,72,129,58,71,2025-07-31
2018,도곡면,월곡1리,40,73,34,39,2025-07-31
2018,도곡면,월곡2리,44,76,31,45,2025-07-31
2018,도곡면,월곡3리,43,82,46,36,2025-07-31
2018,도곡면,쌍옥1리,76,143,65,78,2025-07-31
2018,도곡면,쌍옥2리,65,110,51,59,2025-07-31
2018,도곡면,평리,84,149,74,75,2025-07-31
2018,도곡면,덕곡1리,41,56,25,31,2025-07-31
2018,도곡면,덕곡2리,32,61,32,29,2025-07-31
2018,도곡면,신성1리,56,99,48,51,2025-07-31
2018,도곡면,신성2리,39,73,34,39,2025-07-31
2018,도곡면,천암리,224,466,226,240,2025-07-31
2018,도곡면,원화1리,84,151,73,78,2025-07-31
2018,도곡면,원화2리,44,82,43,39,2025-07-31
2018,도곡면,신덕1리,49,82,43,39,2025-07-31
2018,도곡면,신덕2리,42,70,30,40,2025-07-31
2018,도곡면,신덕3리,41,75,34,41,2025-07-31
2018,도곡면,미곡1리,33,58,28,30,2025-07-31
2018,도곡면,미곡2리,47,84,42,42,2025-07-31
2018,도곡면,죽청1리,75,146,79,67,2025-07-31
2018,도곡면,죽청2리,25,37,16,21,2025-07-31
2018,도암면,운월1리,38,66,33,33,2025-07-31
2018,도암면,운월2리,29,51,28,23,2025-07-31
2018,도암면,도장리,60,121,58,63,2025-07-31
2018,도암면,벽지1리,28,45,21,24,2025-07-31
2018,도암면,벽지2리,19,47,30,17,2025-07-31
2018,도암면,정천리,74,125,67,58,2025-07-31
2018,도암면,원천1리,53,91,44,47,2025-07-31
2018,도암면,원천2리,26,45,24,21,2025-07-31
2018,도암면,원천3리,62,103,45,58,2025-07-31
2018,도암면,천태1리,38,71,41,30,2025-07-31
2018,도암면,천태2리,48,84,41,43,2025-07-31
2018,도암면,지월1리,19,33,21,12,2025-07-31
2018,도암면,지월2리,31,51,23,28,2025-07-31
2018,도암면,지월3리,17,31,14,17,2025-07-31
2018,도암면,등광리,52,85,46,39,2025-07-31
2018,도암면,대초리,32,50,27,23,2025-07-31
2018,도암면,용강1리,46,66,33,33,2025-07-31
2018,도암면,용강2리,30,48,21,27,2025-07-31
2018,도암면,용강3리,38,72,39,33,2025-07-31
2018,도암면,호암1리,25,38,20,18,2025-07-31
2018,도암면,호암2리,21,33,17,16,2025-07-31
2018,도암면,우치리,26,38,17,21,2025-07-31
2018,도암면,봉하리,23,42,26,16,2025-07-31
2018,도암면,왕정리,7,12,9,3,2025-07-31
2018,도암면,행산리,10,18,9,9,2025-07-31
2018,이서면,서리,17,20,13,7,2025-07-31
2018,이서면,월산리,4,6,4,2,2025-07-31
2018,이서면,창랑리,29,43,22,21,2025-07-31
2018,이서면,도석리,3,11,6,5,2025-07-31
2018,이서면,야사1리,58,103,51,52,2025-07-31
2018,이서면,야사2리,61,106,51,55,2025-07-31
2018,이서면,야사3리,19,35,17,18,2025-07-31
2018,이서면,야사4리,26,45,21,24,2025-07-31
2018,이서면,보월1리,62,107,54,53,2025-07-31
2018,이서면,보월2리,25,33,15,18,2025-07-31
2018,이서면,인계1리,25,39,23,16,2025-07-31
2018,이서면,인계2리,39,78,43,35,2025-07-31
2018,이서면,인계3리,22,36,17,19,2025-07-31
2018,이서면,영평1리,69,122,57,65,2025-07-31
2018,이서면,영평2리,19,29,17,12,2025-07-31
2018,이서면,안심1리,60,109,53,56,2025-07-31
2018,이서면,안심2리,20,38,24,14,2025-07-31
2018,이서면,갈두리,6,15,9,6,2025-07-31
2018,백아면,임곡리,53,104,55,49,2025-07-31
2018,백아면,옥1리,56,100,46,54,2025-07-31
2018,백아면,옥2리,31,47,27,20,2025-07-31
2018,백아면,서유1리,58,100,48,52,2025-07-31
2018,백아면,서유2리,25,38,23,15,2025-07-31
2018,백아면,맹리,40,59,34,25,2025-07-31
2018,백아면,남치리,45,86,38,48,2025-07-31
2018,백아면,원리,108,197,94,103,2025-07-31
2018,백아면,송단1리,31,50,25,25,2025-07-31
2018,백아면,송단2리,47,70,37,33,2025-07-31
2018,백아면,방리,28,50,27,23,2025-07-31
2018,백아면,노기리,35,60,30,30,2025-07-31
2018,백아면,이천1리,50,93,48,45,2025-07-31
2018,백아면,이천2리,74,112,53,59,2025-07-31
2018,백아면,길성리,53,75,32,43,2025-07-31
2018,백아면,와천리,16,28,14,14,2025-07-31
2018,백아면,다곡리,43,59,28,31,2025-07-31
2018,백아면,수리,82,131,60,71,2025-07-31
2018,백아면,노치리,23,54,30,24,2025-07-31
2018,백아면,용곡1리,45,65,31,34,2025-07-31
2018,백아면,용곡2리,19,26,11,15,2025-07-31
2018,동복면,독상리,120,209,96,113,2025-07-31
2018,동복면,칠정1리,48,84,44,40,2025-07-31
2018,동복면,칠정2리,31,55,26,29,2025-07-31
2018,동복면,천변리,91,185,85,100,2025-07-31
2018,동복면,유천리,85,146,70,76,2025-07-31
2018,동복면,신율1리,39,79,43,36,2025-07-31
2018,동복면,신율2리,25,44,25,19,2025-07-31
2018,동복면,신율3리,34,61,30,31,2025-07-31
2018,동복면,가수1리,39,73,36,37,2025-07-31
2018,동복면,가수2리,17,40,20,20,2025-07-31
2018,동복면,가수3리,18,24,11,13,2025-07-31
2018,동복면,안성1리,24,43,24,19,2025-07-31
2018,동복면,안성2리,37,53,26,27,2025-07-31
2018,동복면,연월1리,42,64,24,40,2025-07-31
2018,동복면,연월2리,34,63,25,38,2025-07-31
2018,동복면,연월3리,30,51,28,23,2025-07-31
2018,동복면,읍애리,38,66,36,30,2025-07-31
2018,동복면,연둔1리,35,52,24,28,2025-07-31
2018,동복면,연둔2리,19,30,11,19,2025-07-31
2018,동복면,구암1리,34,72,35,37,2025-07-31
2018,동복면,구암2리,26,45,18,27,2025-07-31
2018,동복면,한천리,102,158,66,92,2025-07-31
2018,사평면,사평1리,54,100,51,49,2025-07-31
2018,사평면,사평2리,61,116,59,57,2025-07-31
2018,사평면,사평3리,55,117,61,56,2025-07-31
2018,사평면,사평4리,52,101,46,55,2025-07-31
2018,사평면,사평5리,70,124,56,68,2025-07-31
2018,사평면,대곡1리,40,85,43,42,2025-07-31
2018,사평면,대곡2리,26,36,18,18,2025-07-31
2018,사평면,검산1리,36,75,40,35,2025-07-31
2018,사평면,검산2리,19,32,19,13,2025-07-31
2018,사평면,운산리,33,50,26,24,2025-07-31
2018,사평면,원1리,55,100,53,47,2025-07-31
2018,사평면,원2리,34,66,36,30,2025-07-31
2018,사평면,벽송1리,105,204,61,110,2025-07-31
2018,사평면,벽송2리,25,45,26,19,2025-07-31
2018,사평면,장전1리,48,91,43,48,2025-07-31
2018,사평면,장전2리,35,78,45,33,2025-07-31
2018,사평면,절산1리,67,118,55,63,2025-07-31
2018,사평면,절산2리,39,72,31,41,2025-07-31
2018,사평면,사수1리,21,33,18,15,2025-07-31
2018,사평면,사수2리,28,39,20,19,2025-07-31
2018,사평면,주산리,25,47,22,25,2025-07-31
2018,사평면,복교리,9,22,14,8,2025-07-31
2018,사평면,남계리,56,86,39,47,2025-07-31
2018,사평면,유마리,29,53,27,26,2025-07-31
2018,사평면,다산리,63,104,53,51,2025-07-31
2018,사평면,용1리,21,32,14,18,2025-07-31
2018,사평면,용2리,45,77,39,38,2025-07-31
2018,사평면,내1리,27,45,21,24,2025-07-31
2018,사평면,내2리,27,40,20,20,2025-07-31
2018,사평면,내3리,35,64,37,27,2025-07-31
2018,동면,백용1리,44,67,30,37,2025-07-31
2018,동면,백용2리,17,33,14,19,2025-07-31
2018,동면,언도1리,41,60,32,28,2025-07-31
2018,동면,언도2리,62,108,53,55,2025-07-31
2018,동면,서성1리,33,55,26,29,2025-07-31
2018,동면,서성2리,66,124,64,60,2025-07-31
2018,동면,국동리,46,122,63,59,2025-07-31
2018,동면,청궁리,32,62,33,29,2025-07-31
2018,동면,마산리,23,49,28,21,2025-07-31
2018,동면,무포1리,44,90,39,51,2025-07-31
2018,동면,무포2리,83,157,86,71,2025-07-31
2018,동면,경치1리,59,89,41,48,2025-07-31
2018,동면,경치2리,153,243,140,103,2025-07-31
2018,동면,복암1리,43,60,25,35,2025-07-31
2018,동면,복암2리,38,72,31,41,2025-07-31
2018,동면,복암3리,33,63,33,30,2025-07-31
2018,동면,오동1리,54,100,48,52,2025-07-31
2018,동면,오동2리,57,110,52,58,2025-07-31
2018,동면,오동3리,131,232,116,116,2025-07-31
2018,동면,천덕1리,31,55,30,25,2025-07-31
2018,동면,천덕2리,54,105,54,51,2025-07-31
2018,동면,천덕3리,41,75,38,37,2025-07-31
2018,동면,장동1리,32,47,23,24,2025-07-31
2018,동면,장동2리,15,29,15,14,2025-07-31
2018,동면,운농1리,80,135,72,63,2025-07-31
2018,동면,운농2리,73,122,76,46,2025-07-31
2018,동면,운농3리,61,119,61,58,2025-07-31
2018,동면,옥호1리,156,282,133,149,2025-07-31
2018,동면,옥호2리,98,179,79,100,2025-07-31
2018,동면,옥호3리,54,91,57,34,2025-07-31
2018,동면,대포1리,43,90,46,44,2025-07-31
2018,동면,대포2리,81,164,79,85,2025-07-31
2018,동면,대포3리,92,148,72,76,2025-07-31
2019,화순읍,화순읍,16556,39059,19224,19835,2025-07-31
2019,한천면,한천면,815,1385,707,678,2025-07-31
2019,춘양면,춘양면,1076,1844,921,923,2025-07-31
2019,청풍면,청풍면,658,1051,506,545,2025-07-31
2019,이양면,이양면,1116,1869,904,965,2025-07-31
2019,능주면,능주면,1648,3302,1645,1657,2025-07-31
2019,도곡면,도곡면,1581,2850,1407,1443,2025-07-31
2019,도암면,도암면,866,1461,765,696,2025-07-31
2019,이서면,이서면,588,985,506,479,2025-07-31
2019,북면,북면,973,1575,781,794,2025-07-31
2019,동복면,동복면,979,1664,790,874,2025-07-31
2019,남면,남면,1261,2220,1130,1090,2025-07-31
2019,동면,동면,1986,3472,1775,1697,2025-07-31
2020,화순읍,화순읍,17102,39066,19201,19865,2025-07-31
2020,한천면,한천면,832,1360,683,677,2025-07-31
2020,춘양면,춘양면,1101,1810,923,887,2025-07-31
2020,청풍면,청풍면,689,1041,504,537,2025-07-31
2020,이양면,이양면,1135,1798,877,921,2025-07-31
2020,능주면,능주면,1650,3269,1607,1662,2025-07-31
2020,도곡면,도곡면,1664,2901,1436,1465,2025-07-31
2020,도암면,도암면,886,1436,740,696,2025-07-31
2020,이서면,이서면,612,1002,518,484,2025-07-31
2020,백아면,백아면,1025,1597,798,799,2025-07-31
2020,동복면,동복면,991,1625,765,860,2025-07-31
2020,사평면,사평면,1302,2182,1112,1070,2025-07-31
2020,동면,동면,2020,3435,1742,1693,2025-07-31
2021,화순읍,화순읍,18030,39707,19477,20230,2025-07-31
2021,한천면,한천면,849,1348,676,672,2025-07-31
2021,춘양면,춘양면,1097,1755,896,859,2025-07-31
2021,청풍면,청풍면,711,1040,504,536,2025-07-31
2021,이양면,이양면,1140,1778,871,907,2025-07-31
2021,능주면,능주면,1716,3186,1567,1619,2025-07-31
2021,도곡면,도곡면,1671,2850,1422,1428,2025-07-31
2021,도암면,도암면,883,1426,727,699,2025-07-31
2021,이서면,이서면,598,949,490,459,2025-07-31
2021,백아면,백아면,1027,1577,783,794,2025-07-31
2021,동복면,동복면,995,1595,756,839,2025-07-31
2021,사평면,사평면,1306,2120,1069,1051,2025-07-31
2021,동면,동면,1989,3293,1672,1621,2025-07-31
2022,화순읍,화순읍,18214,39694,19441,20253,2025-07-31
2022,한천면,한천면,849,1317,665,652,2025-07-31
2022,춘양면,춘양면,1123,1759,906,853,2025-07-31
2022,청풍면,청풍면,704,1024,503,521,2025-07-31
2022,이양면,이양면,1145,1770,858,912,2025-07-31
2022,능주면,능주면,1673,3070,1522,1548,2025-07-31
2022,도곡면,도곡면,1666,2821,1412,1409,2025-07-31
2022,도암면,도암면,898,1419,732,687,2025-07-31
2022,이서면,이서면,596,948,486,462,2025-07-31
2022,백아면,백아면,1029,1562,786,776,2025-07-31
2022,동복면,동복면,991,1588,755,833,2025-07-31
2022,사평면,사평면,1296,2101,1076,1025,2025-07-31
2022,동면,동면,1972,3242,1651,1591,2025-07-31
2023,화순읍,화순읍,18287,39253,19203,20050,2025-07-31
2023,한천면,한천면,846,1328,667,661,2025-07-31
2023,춘양면,춘양면,1108,1735,894,841,2025-07-31
2023,청풍면,청풍면,693,1004,492,512,2025-07-31
2023,이양면,이양면,1167,1776,870,906,2025-07-31
2023,능주면,능주면,1633,3019,1486,1533,2025-07-31
2023,도곡면,도곡면,1666,2819,1419,1400,2025-07-31
2023,도암면,도암면,895,1395,729,666,2025-07-31
2023,이서면,이서면,585,919,476,443,2025-07-31
2023,백아면,백아면,1035,1551,785,766,2025-07-31
2023,동복면,동복면,987,1545,741,804,2025-07-31
2023,사평면,사평면,1267,2032,1052,980,2025-07-31
2023,동면,동면,1983,3183,1625,1558,2025-07-31
2024,화순읍,화순읍,18314,39138,19150,19988,2025-07-31
2024,한천면,한천면,824,1309,667,642,2025-07-31
2024,춘양면,춘양면,1088,1720,891,829,2025-07-31
2024,청풍면,청풍면,681,970,487,483,2025-07-31
2024,이양면,이양면,1135,1730,863,867,2025-07-31
2024,능주면,능주면,1571,2927,1445,1482,2025-07-31
2024,도곡면,도곡면,1623,2745,1402,1343,2025-07-31
2024,도암면,도암면,891,1366,713,653,2025-07-31
2024,이서면,이서면,599,941,491,450,2025-07-31
2024,백아면,백아면,1025,1537,774,763,2025-07-31
2024,동복면,동복면,978,1508,727,781,2025-07-31
2024,사평면,사평면,1258,2003,1032,971,2025-07-31
2024,동면,동면,1920,3025,1561,1464,2025-07-31
2025,화순읍,화순읍,18361,38992,19042,19950,2025-07-31
2025,한천면,한천면,831,1311,667,644,2025-07-31
2025,춘양면,춘양면,1037,1653,862,791,2025-07-31
2025,청풍면,청풍면,666,959,489,470,2025-07-31
2025,이양면,이양면,1090,1681,851,830,2025-07-31
2025,능주면,능주면,1557,2869,1405,1464,2025-07-31
2025,도곡면,도곡면,1589,2709,1397,1312,2025-07-31
2025,도암면,도암면,878,1329,694,635,2025-07-31
2025,이서면,이서면,589,938,482,456,2025-07-31
2025,백아면,백아면,1000,1489,760,729,2025-07-31
2025,동복면,동복면,967,1463,699,764,2025-07-31
2025,사평면,사평면,1277,2057,1063,994,2025-07-31
2025,동면,동면,1844,2949,1518,1431,2025-07-31
